a	a
ã	a
aala	a a l a
aba	a b a
abaa	a b a a
äbab	a b a b
æbæq̠	æ b æ k
abeɾaxd	a b e ɾ a f d
abia	a b i a
abja	a b j a
abo	a b o
abobi	a b o b i
æbru	æ b ɾ u
abwa	a b w a
abwe	a b w e
abɛ	a b ɛ
abɪ	a b ɪ
abɛn	a b ɛ n
abʒə	a b ʒ ə
äc	a c
acaʕas	a c a ɹ a s
äcinurkʼ	a c i n u ɾ k
acăr	a c a ɾ
ad	a d
ada	a d a
adame	a d a m e
adi	a d i
adjaura	a d j a u ɾ a
adjaɣa	a d j a ɡ a
adu	a d u
adwa	a d w a
adɔ	a d ɔ
adɛ	a d ɛ
adχa	a d f a
ad̠ar	a d a ɾ
ad̪i	a d̪ i
ad͡ʒ	a dʒ
ad͡ʒareori	a dʒ a ɾ e o ɾ i
ad͡ʒmɜ	a dʒ m ɛ
ad̠ʒõ	a d ʒ o
ad͡ʒɘmʃɘ	a dʒ ə m ʃ ə
ad͡ʒɘr	a dʒ ə ɾ
ad͡ʒɘʃ	a dʒ ə ʃ
ad͡ʒʃʲ	a dʒ ʃ
ae	a e
afaama	a f a a m a
afan	a f a n
afe	a f e
aff	a f f
afja	a f j a
afru	a f ɾ u
afu	a f u
afuʃilatu	a f u ʃ i l a t u
afăt̪	a f a t̪
afɛ̃t̪ɛ	a f ɛ t̪ ɛ
aha	a h a
aho	a h o
ahĩ	a h i
ahɛ	a h ɛ
ai	a i
aia	a i a
aid̪u	a i d̪ u
aiqaðə	a i k a ð ə
aita	a i t a
aitːa	a i t a
aiχæ̈	a i f æ
aiŋq̠uɾa	a i ŋ k u ɾ a
aj	a j
aja	a j a
ajala	a j a l a
ajaŋ	a j a ŋ
äjaɡ	a j a ɡ
ajejin	a j e j i n
aju	a j u
ajustar	a j u s t a ɾ
äjwan	a j w a n
ajɪɛ	a j ɪ ɛ
ajəʃʲɛ̈	a j ə ʃ ɛ
ak	a k
aka	a k a
akada	a k a d a
akaj	a k a j
ækælə	æ k æ l ə
akambani	a k a m b a n i
akan	a k a n
akaŋzwinü	a k a ŋ z w i n u
akeklei	a k e k l e i
ako	a k o
akokʷe	a k o kʷ e
akpanakpa	a k p a n a k p a
akpiti	a k p i t i
akpɛtɛt̪	a k p ɛ t ɛ t̪
aku	a k u
akui	a k u i
akuo	a k u o
akwa	a k w a
akyi	a k i i
akɛ	a k ɛ
akʷaa	a kʷ a a
akʼaʒʲərɜ	a k a ʒ ə ɾ ɛ
ak͡pa	a kp a
ak͡pe	a kp e
ak͡po	a kp o
ak͡pɛ	a kp ɛ
akʷɛ	a kʷ ɛ
äkʰʷ	a kʰ
akɛɛɡlɛ	a k ɛ ɛ ɡ l ɛ
al	a l
ala	a l a
alalo	a l a l o
alazi	a l a z i
alaɣa	a l a ɡ a
ald̪apa	a l d̪ a p a
ale	a l e
aleuhat	a l e u h a t
æli	æ l i
alila	a l i l a
ællə	æ l l ə
alo	a l o
älqʼa	a l k a
alq̠o	a l k o
alwin	a l w i n
alxat	a l f a t
alɛ	a l ɛ
al̴l̴a	a l̴ l̴ a
ama	a m a
amani	a m a n i
amata	a m a t a
amma	a m m a
æmma	æ m m a
ampaɾdaq̠	a m p a ɾ d a k
amt͡ʃʼɘ	a m tʃ ə
amɛ	a m ɛ
amɪ	a m ɪ
amɔr	a m ɔ ɾ
amʒɤ̈	a m ʒ ʊ
an	a n
ana	a n a
anam	a n a m
anana	a n a n a
ananvaxzinvoɾməneɾ	a n a n v a f z i n v o ɾ m ə n e ɾ
anaxt͡ʃiq̠məne	a n a f tʃ i k m ə n e
anaŋ	a n a ŋ
andiʔ	a n d i ʔ
aneuk	a n e u k
ani	a n i
anie	a n i e
ano	a n o
ænoʔ	æ n o ʔ
ants̪aɾa	a n t s a ɾ a
ant̪akaɽana	a n t̪ a k a ɹ a n a
antʲs	a n tʲ s
anu	a n u
anübwi	a n u b w i
anümoyi	a n u m o i i
anünuyi	a n u n u i i
anünwi	a n u n w i
anüɲayi	a n u ɲ a i i
anüŋɡweyi	a n u ŋ ɡ w e i i
anzar	a n z a ɾ
anχa	a n f a
anːa	a n a
an̪d̪eɾe	a n  d̪ e ɾ e
an̪d̪u	a n  d̪ u
an̠jɔ	a n j ɔ
an̪n̪a	a n  n  a
apaŋ	a p a ŋ
apaɾi	a p a ɾ i
ãpo	a p o
apt͡ʃra	a p tʃ ɾ a
apu	a p u
apɛ	a p ɛ
apən	a p ə n
apʰɔncɪ̃	a pʰ ɔ n c ɪ
aq̠	a k
aq̠a	a k a
æq̠æb	æ k æ b
aq̠ad	a k a d
aq̠ba	a k b a
aq̠bo	a k b o
aq̠bɔ	a k b ɔ
aq̠bɔ̃	a k b ɔ
aq̠q̠u	a k k u
aq̠st	a k s t
aqʰəɮənt͡ʃa	a kʰ ə ɫ ə n tʃ a
ara	a ɾ a
äräf	a ɾ a f
arana	a ɾ a n a
araːbə	a ɾ aː b ə
ärcaj	a ɾ c a j
arcʼulf	a ɾ c u l f
ard	a ɾ d
areŋku	a ɾ e ŋ k u
ari	a ɾ i
ariːja	a ɾ iː j a
ariːna	a ɾ iː n a
ærmænestan	æ ɾ m æ n e s t a n
aroht͡ʃ	a ɾ o h tʃ
arɪ	a ɾ ɪ
as	a s
asa	a s a
asaa	a s a a
asan	a s a n
äsas	a s a s
asd	a s d
asef	a s e f
asi	a s i
asif	a s i f
asjak	a s j a k
aso	a s o
ãsor	a s o ɾ
asuf	a s u f
aswi	a s w i
asɔ	a s ɔ
ata	a t a
atab	a t a b
atap	a t a p
atar	a t a ɾ
ataɲa	a t a ɲ a
ate	a t e
ateepu	a t e e p u
ati	a t i
atinsak	a t i n s a k
atinŋek	a t i n ŋ e k
atõ	a t o
atsʁʷərə	a t s f  ə ɾ ə
att͡ʃʃʰɜrɜ	a t tʃ ʃ ɛ ɾ ɛ
atufien	a t u f i e n
atwa	a t w a
atwi	a t w i
atɛ	a t ɛ
at̪ʰ	a tʰ
ãt͡ʃ	a tʃ
at͡ʃa	a tʃ a
at̠ʃaʔə	a t ʃ a ʔ ə
at̠ɕu	a t ʃ u
at̠ɕɔ	a t ʃ ɔ
at̠ɕɛ	a t ʃ ɛ
at͡ʃə	a tʃ ə
at͡ʃʼa	a tʃ a
at͡ʃʰbɘɡə	a tʃ b ə ɡ ə
at͡ʃədæ̈	a tʃ ə d æ
at͡ʃʰnɘ	a tʃ n ə
at͡ʃʼɘ	a tʃ ə
at͡ʃə̆pʰɜ̆rʌ̈	a tʃ ə pʰ ɛ  ɾ ə
at͡ʃʰɜrä	a tʃ ɛ ɾ a
at͡ʃʰɘɥrɜ	a tʃ ə w ɾ ɛ
at͡ʃʼɘχrɜ	a tʃ ə f ɾ ɛ
au	a u
audituːr	a u d i t uː ɾ
auksts	a u k s t s
aurinaːr	a u ɾ i n aː ɾ
autuːr	a u t uː ɾ
autə	a u t ə
auʃaː	a u ʃ aː
auːt	a uː t
ava	a v a
avana	a v a n a
avaz	a v a z
aw	a w
awa	a w a
awancʼaj	a w a n c a j
awe	a w e
awi	a w i
awo	a w o
awraɣ	a w ɾ a ɡ
awun	a w u n
æxadə	æ f a d ə
axarvar	a f a ɾ v a ɾ
axor	a f o ɾ
axpʰ	a f pʰ
axt͡ʃiq̠	a f tʃ i k
ayi	a i i
ayu	a i u
azadʰ	a z a d
azd̠id̠	a z d i d
azi	a z i
azii	a z i i
ãzor	a z o ɾ
azoːça	a z oː ç a
azoːdja	a z oː d j a
azoːsiq̠a	a z oː s i k a
azoːsiːq̠a	a z oː s iː k a
azoːt̠ʃ̠uɾa	a z oː t ʃ u ɾ a
azoːt̠ʃ̠uːɾa	a z oː t ʃ uː ɾ a
azur	a z u ɾ
azzar	a z z a ɾ
aː	aː
aɟa	a ɟ a
aɡa	a ɡ a
aɣa	a ɡ a
aɲa	a ɲ a
aɹa	a ɹ a
aʁa	a f a
aɹaba	a ɹ a b a
aʒan	a ʒ a n
æɾæpeɪʃ	æ ɾ æ p e ɪ ʃ
aɡara	a ɡ a ɾ a
aɾat̪inĩk	a ɾ a t̪ i n i k
aɽaʔ	a ɹ a ʔ
aɾaʔ	a ɾ a ʔ
aʃæ̈	a ʃ æ
aχaɡə	a f a ɡ ə
aɡba	a ɡ b a
aɡbaha	a ɡ b a h a
aɡbeipoi	a ɡ b e i p o i
aɡbɛhii	a ɡ b ɛ h i i
aːdaːz	aː d aː z
æːdʊ	æ d ʊ
äʁdərɜ	a f d ə ɾ ɛ
aːe	aː e
a˞e˞	ɚ ɚ
aɣeɾt̪u	a ɡ e ɾ t̪ u
aʍeʍɛ	a w e w ɛ
aɱfɛtamina	a m f ɛ t a m i n a
aʃi	a ʃ i
aŋka	a ŋ k a
aŋkõŋ	a ŋ k o ŋ
aŋmɔ	a ŋ m ɔ
æːmənə	æ m ə n ə
aɪn	a ɪ n
aːna	aː n a
aɡo	a ɡ o
aɣod	a ɡ o d
aɾod	a ɾ o d
aβoβaɾimuːnzu	a v o v a ɾ i m uː n z u
aβoβaːɾimuːnzu	a v o v aː ɾ i m uː n z u
aːq̠ɔ	aː k ɔ
aːr	aː ɾ
aχrdzɛ̈	a f ɾ d z ɛ
aːref	aː ɾ e f
aːri	aː ɾ i
äχrɛ̈	a f ɾ ɛ
aɛtos	a ɛ t o s
aɪtə	a ɪ t ə
aʃun	a ʃ u n
aβuɾu	a v u ɾ u
aŋwa	a ŋ w a
aŋwaa	a ŋ w a a
aŋwaan	a ŋ w a a n
aŋwinö	a ŋ w i n o
aːzik	aː z i k
aŋɔ	a ŋ ɔ
aŋɛ	a ŋ ɛ
aɣɯ	a ɡ ʊ
aʃɔ	a ʃ ɔ
aʃə	a ʃ ə
aʍɛ	a w ɛ
aχɘ	a f ə
äɡʷ	a ɡʷ
aɳɳa	a ɲ  ɲ  a
aŋʷa	a ŋ a
aɹ̝a	a ɹ a
aɛɾas	a ɛ ɾ a s
aɡ͡ble	a ɡb l e
aʃɘpɘ	a ʃ ə p ə
aχəra	a f ə ɾ a
aʁɛst	a f ɛ s t
aʃʲtʲ	a ʃ tʲ
aχʲtʰɛ̈	a f tʰ ɛ
äʒɹə	a ʒ ɹ ə
æʋʋɑr	æ ʋ ʋ ɑ ɾ
ãːɣər	aː ɡ ə ɾ
aχʲɘts	a f ə t s
aʃəɾɜ	a ʃ ə ɾ ɛ
aăʒɔəlas	a a ʒ ɔ ə l a s
aːʒɔəlʲɛ̞	aː ʒ ɔ ə l ɛ
aχʲɾɛ̈	a f ɾ ɛ
äʒəħœ̈ɾə	a ʒ ə h o ɾ ə
ba	b a
bã	b a
baaj	b a a j
baba	b a b a
babʷa	b a b a
bæbʷɛn	b æ b ɛ n
bæbʷɛq̠	b æ b ɛ k
bacam	b a c a m
bæd	b æ d
badza	b a d z a
badzar	b a d z a ɾ
bæd̪aʕ	b æ d̪ a ɹ
bæd̪əʔ	b æ d̪ ə ʔ
bafa	b a f a
bah	b a h
bahː	b a h
baine	b a i n e
baiːr	b a iː ɾ
baiːðɪr	b a iː ð ɪ ɾ
baja	b a j a
bãj̃ã	b a j a
bak	b a k
baka	b a k a
bakal	b a k a l
bakas	b a k a s
baka̠ʔcu	b a k a ʔ c u
bakbak	b a k b a k
bak͡pak	b a kp a k
bal	b a l
bala	b a l a
bæla	b æ l a
balai	b a l a i
balakaŋ	b a l a k a ŋ
bælal	b æ l a l
balaq̠	b a l a k
balat	b a l a t
bælaħ	b æ l a h
bælaʕ	b æ l a ɹ
bællal	b æ l l a l
balloʔ	b a l l o ʔ
bælːa	b æ l a
bal̪ːu	b a l u
bama	b a m a
ban	b a n
bana	b a n a
bæna	b æ n a
banahaw	b a n a h a w
banda	b a n d a
bandʷap	b a n d a p
banq̠ã	b a n k a
bænːa	b æ n a
bapap	b a p a p
bapʷa	b a pʷ a
baq̠ah	b a k a h
baq̠aʔ	b a k a ʔ
bar	b a ɾ
bara	b a ɾ a
bæradær̥	b æ ɾ a d æ ɾ
bærrəd	b æ ɾ ɾ ə d
barɦ	b a ɾ h
bærəd̪	b æ ɾ ə d̪
bærɢi	b æ ɾ ɡ i
basa	b a s a
basah	b a s a h
basfa	b a s f a
baskap	b a s k a p
bat	b a t
bata	b a t a
batat	b a t a t
batei	b a t e i
batsa	b a t s a
batsfap	b a t s f a p
battəl	b a t t ə l
batu	b a t u
batʷap	b a tʷ a p
batəl	b a t ə l
bat͡ɬʼ	b a tʃ
baul	b a u l
bauɲcɪ	b a u ɲ c ɪ
bauːðɪr	b a uː ð ɪ ɾ
bawam	b a w a m
baxiːl	b a f iː l
bazap	b a z a p
bazɫ̩	b a z ɫ̩
baɾ	b a ɾ
baʔ	b a ʔ
baŋa	b a ŋ a
baʃa	b a ʃ a
baʔa	b a ʔ a
baɡam	b a ɡ a m
baʒap	b a ʒ a p
baʔar	b a ʔ a ɾ
baŋaŋ	b a ŋ a ŋ
baɲaŋ	b a ɲ a ŋ
bæːb	b æ b
bæːd	b æ d
baŋk	b a ŋ k
baːk	b aː k
baŋka	b a ŋ k a
baŋkaʔ	b a ŋ k a ʔ
baːki	b aː k i
baːla	b aː l a
baɡnis	b a ɡ n i s
baːr	b aː ɾ
baʈsva	b a ʈ s v a
baɪt	b a ɪ t
baɾtkeɾ	b a ɾ t k e ɾ
bæːt̪t̪	b æ t̪ t̪
baːð	b aː ð
baʔːa	b a ʔ a
baːɽa	b aː ɹ a
baŋɡak	b a ŋ ɡ a k
baŋʷaŋ	b a ŋ a ŋ
baɳɖe	b a ɲ  ɖ e
baːʃi	b aː ʃ i
bãɲə̥	b a ɲ ə
baŋɡʷa	b a ŋ ɡʷ a
bba	b b a
be	b e
becʷʰ	b e cʷ
behtaɾ	b e h t a ɾ
beiːð	b e iː ð
bekatu	b e k a t u
bene	b e n e
beni	b e n i
ben̪a	b e n  a
ben̪ki	b e n  k i
bepa	b e p a
bepːa	b e p a
beqʼut͡ɬ	b e k u tʃ
beseri	b e s e ɾ i
bet	b e t
betoker	b e t o k e ɾ
betute	b e t u t e
beunq̠ah	b e u n k a h
bezvlast̪ʃe	b e z v l a s t̪ ʃ e
beʔ	b e ʔ
beχ	b e f
beː	b eː
be˞	b ɚ
beːjə	b eː j ə
beɪn̪	b e ɪ n 
beɪt	b e ɪ t
beɪtna	b e ɪ t n a
beɪt̪	b e ɪ t̪
beːðə	b eː ð ə
bi	b i
biaaŋa	b i a a ŋ a
bidu	b i d u
bid͡ʒɑɬɑ	b i dʒ ɑ ɫ ɑ
bie	b i e
bien	b i e n
bifarriʁ	b i f a ɾ ɾ i f
bifarrɪχ	b i f a ɾ ɾ ɪ f
biki	b i k i
biko	b i k o
binaŋa	b i n a ŋ a
bini	b i n i
bir	b i ɾ
bist	b i s t
bit	b i t
biti	b i t i
bitis	b i t i s
bitsɑq̠ɑ̃	b i t s ɑ k ɑ
bitɑq̠ɑ̃	b i t ɑ k ɑ
bizʊlua	b i z ʊ l u a
biʃ	b i ʃ
biːni	b iː n i
biːr	b iː ɾ
biət	b i ə t
biːð	b iː ð
biːðə	b iː ð ə
biɛŋki	b i ɛ ŋ k i
bjaːr	b j aː ɾ
blo	b l o
blœyt	b l o i t
blœyːt	b l o i t
bn	b n
bo	b o
boalbola	b o a l b o l a
bøb	b o b
bødə	b o d ə
boeʔ	b o e ʔ
bokeʁ	b o k e f
bokɛʁ	b o k ɛ f
bom	b o m
bono	b o n o
bon̪a	b o n  a
boq̠q̠o	b o k k o
bør	b o ɾ
boraĩ	b o ɾ a i
bosə	b o s ə
bot	b o t
bouːr	b o uː ɾ
bøːrɛ	b o ɾ ɛ
bøːðə	b o ð ə
bratː	b ɾ a t
brekt	b ɾ e k t
brẽkat	b ɾ e k a t
brɛkːa	b ɾ ɛ k a
bubu	b u b u
bubun	b u b u n
bud	b u d
budi̠ca̠da̠ʔ	b u d i c a d a ʔ
bui	b u i
buisit	b u i s i t
bukɑr	b u k ɑ ɾ
bulana	b u l a n a
bulat͡ɬ	b u l a tʃ
buluz	b u l u z
bunq̠onq̠	b u n k o n k
buq̠ɑs	b u k ɑ s
burabun	b u ɾ a b u n
buruu	b u ɾ u u
busata	b u s a t a
buskar	b u s k a ɾ
buso	b u s o
buta	b u t a
butunis	b u t u n i s
butə	b u t ə
buzuɑ	b u z u ɑ
buːr	b uː ɾ
buːs	b uː s
buːt̪	b uː t̪
buːð	b uː ð
buə̯t	b u ə t
bwa	b w a
byen	b i e n
byːðə	b i ð ə
bz	b z
bzadʑa	b z a d ʒ a
bzakʰʷa	b z a kʰ a
bzaŋa	b z a ŋ a
bzəy	b z ə i
bĩ	b i
bɔ	b ɔ
bʷa	b a
băadas	b a a d a s
bʰaja	b a j a
bɾasə	b ɾ a s ə
bɑbɑ	b ɑ b ɑ
bɑbɑːɾ	b ɑ b ɑː ɾ
bɑd	b ɑ d
bədd	b ə d d
bədzə	b ə d z ə
bˀekaarii	b e k a a ɾ i i
bʲekʲtʲ	bʲ e k tʲ
bˀet̟ɕoodii	b e t ʃ o o d i i
bˀeŋɡarii	b e ŋ ɡ a ɾ i i
bɑh	b ɑ h
bɞhuq̠u	b ə h u k u
bɑhɾ	b ɑ h ɾ
bɛi̯ki	b ɛ i k i
bʲiːla	bʲ iː l a
bɑk	b ɑ k
bʊk	b ʊ k
bɛkə	b ɛ k ə
bɑkʲə	b ɑ k ə
bɑl	b ɑ l
bɛla	b ɛ l a
bəlud	b ə l u d
bəludbolud	b ə l u d b o l u d
bən	b ə n
bəne	b ə n e
bɑnk	b ɑ n k
bɑnsɑ	b ɑ n s ɑ
bʌnə	b ə n ə
bɑo	b ɑ o
bɑpoɾ	b ɑ p o ɾ
bɔr	b ɔ ɾ
bɪr	b ɪ ɾ
bʊr	b ʊ ɾ
bʌra	b ə ɾ a
bɛrɾq̠ə	b ɛ ɾ ɾ k ə
bɑs	b ɑ s
bɔs	b ɔ s
bʌs	b ə s
bɑsmɑx	b ɑ s m ɑ f
bɛst	b ɛ s t
bɛstõz	b ɛ s t o z
bʊsʊm	b ʊ s ʊ m
bɑt	b ɑ t
bɔt	b ɔ t
bət	b ə t
bɛt	b ɛ t
bɪt	b ɪ t
bɔti	b ɔ t i
bəton	b ə t o n
bɑtu	b ɑ t u
bɑtu̝	b ɑ t u
bətuən	b ə t u ə n
bɛtʰkʰ	b ɛ tʰ kʰ
bʌtɪʔ	b ə t ɪ ʔ
bɪtːʃa	b ɪ t ʃ a
bɑt͡ʃə	b ɑ tʃ ə
bɑx	b ɑ f
bœyːð	b o i ð
bɪzɪz	b ɪ z ɪ z
bəzːɒ	b ə z ɒ
bũũ	b u u
bɑə	b ɑ ə
bɑɾ	b ɑ ɾ
bɑʃ	b ɑ ʃ
bəʔ	b ə ʔ
bɔː	b ɔ
bəɽa	b ə ɹ a
bɪʁalli	b ɪ f a l l i
bɑːb	b ɑː b
bɑːbɔɪ	b ɑː b ɔ ɪ
bɛʃdiwoʒi	b ɛ ʃ d i w o ʒ i
bɹɑdɑn	b ɹ ɑ d ɑ n
bʌʉdɫ̩	b ə ʉ d ɫ̩
bə̟i̯	b ə i
bɑːiːki	b ɑː iː k i
bɑːi̯ki	b ɑː i k i
bə̟i̯ki	b ə i k i
bə̟i̯t	b ə i t
bʊ̟i̯t	b ʊ i t
bɛ̞ki	b ɛ k i
bɔɪkots	b ɔ ɪ k o t s
bəŋkə	b ə ŋ k ə
bɑʃmɑx	b ɑ ʃ m ɑ f
bɪəpbɪəb	b ɪ ə p b ɪ ə b
bɮəpqʰ	b ɫ ə p kʰ
bəŋq̠əs	b ə ŋ k ə s
bɔːr	b ɔ ɾ
bɛːr	b ɛ ɾ
bɪːr	b ɪ ɾ
bʏːr	b uː ɾ
bəʔs	b ə ʔ s
bɑːs	b ɑː s
bɛʔst	b ɛ ʔ s t
bɛɪt	b ɛ ɪ t
bʌʉt	b ə ʉ t
bɑːt	b ɑː t
bɔ̃ti	b ɔ t i
bɨ̠tna̠ʔ	b ɪ t n a ʔ
bʰʊt̪	b ʊ t̪
bʌʉtɫ̩	b ə ʉ t ɫ̩
b̤ɦulana	b h u l a n a
bœːð	b oː ð
bɔːð	b ɔ ð
bɛːð	b ɛ ð
bɪːð	b ɪ ð
bɔɣɔ	b ɔ ɡ ɔ
bɑːɾ	b ɑː ɾ
bɛɟːa	b ɛ ɟ a
bɪχɛlli	b ɪ f ɛ l l i
bʁœːlə	b f oː l ə
bɑɾɑn	b ɑ ɾ ɑ n
bɑχər	b ɑ f ə ɾ
bɑχɑsi	b ɑ f ɑ s i
bʊ̟ɪt	b ʊ ɪ t
bɛʔɛ̠	b ɛ ʔ ɛ
bɒθːɒ	b ɒ θ ɒ
bəʒɪʃkaq̠an	b ə ʒ ɪ ʃ k a k a n
cä	c a
caada̠ʔ	c a a d a ʔ
caca	c a c a
cahchapəm	c a h c h a p ə m
çal	ç a l
cam	c a m
çauː	ç a uː
cay	c a i
caːla	c aː l a
caχma	c a f m a
cc	c c
cça	c ç a
cçəɽa	c ç ə ɹ a
cey	c e i
cikes	c i k e s
cini	c i n i
ciqʼ	c i k
ciw	c i w
çiʎada	ç i ʎ a d a
ciʕʷəlx	c i ɹ ə l f
cjɔlas	c j ɔ l a s
ckckaɬp	c k c k a ɫ p
cksqaltkəm	c k s k a l t k ə m
cor	c o ɾ
couːl	c o uː l
çouːl	ç o uː l
cuːkʰ	c uː kʰ
cʼä	c a
cʰi	cʰ i
cɪmɛnɛ	c ɪ m ɛ n ɛ
cəncanwayaʔ	c ə n c a n w a i a ʔ
cʰoχa	cʰ o f a
cɪrː	c ɪ ɾ
cɛːr	c ɛ ɾ
da	d a
dã	d a
daa	d a a
dabɪkʰɛ̤	d a b ɪ kʰ ɛ
dada	d a d a
dadidɑ	d a d i d ɑ
dadoɫd͡ʒeq̠	d a d o ɫ dʒ e k
dadⁿ	d a d
daja	d a j a
dal	d a l
dala	d a l a
damaraʔ	d a m a ɾ a ʔ
damma	d a m m a
dan	d a n
danʁʷa	d a n f  a
dapqʰə	d a p kʰ ə
daq̠aʔ	d a k a ʔ
darabə	d a ɾ a b ə
dær̥	d æ ɾ
dauː	d a uː
dæweɪh	d æ w e ɪ h
daɣ	d a ɡ
daʔ	d a ʔ
daɗa	d a d  a
daɽa	d a ɹ a
daɾa	d a ɾ a
daːl	d aː l
daːla	d aː l a
daːt̪	d aː t̪
daːɾa	d aː ɾ a
dbend͡ʒiːl̪	d b e n dʒ iː l
dda	d d a
dde	d d e
ddi	d d i
ddər	d d ə ɾ
de	d e
demkʰ	d e m kʰ
det͡ʃə	d e tʃ ə
dev	d e v
deɪl̪	d e ɪ l
deɪn̪	d e ɪ n 
deːq̠	d eː k
di	d i
dia	d i a
diat	d i a t
dico	d i c o
dimja	d i m j a
dim̥a̰	d i m a
dis	d i s
diso	d i s o
diːt	d iː t
diɢʲ	d i ɡ
djaːr	d j aː ɾ
dlõ	d l o
do	d o
dõ	d o
doç	d o ç
dodoce	d o d o c e
dohoʃ	d o h o ʃ
dol	d o l
dolẽẽ	d o l e e
doma	d o m a
domo	d o m o
doo	d o o
dõõ	d o o
døusdəm	d o u s d ə m
doxː	d o f
doz	d o z
døːbə	d o b ə
doːm	d oː m
døːrɛ	d o ɾ ɛ
doʊ̰ʔ	d o ʊ ʔ
do̰ʊ̰ʔ	d o ʊ ʔ
du	d u
duaq̠	d u a k
dudu	d u d u
dut	d u t
duu	d u u
duːkʰa	d uː kʰ a
dwaːl̪	d w aː l
dyr	d i ɾ
dyvən	d i v ə n
dz	d z
dza	d z a
dzar	d z a ɾ
dzau	d z a u
dzi	d z i
dzo	d z o
dzoːna	d z oː n a
dzuiaŋ	d z u i a ŋ
dzɪ	d z ɪ
dzʲmʲbʲntʲ	d z mʲ bʲ n tʲ
dzŭukas	d z u u k a s
dzɪɬtɑdn̩	d z ɪ ɫ t ɑ d n̩
dzɛʎʊ	d z ɛ ʎ ʊ
dũ	d u
dɔ	d ɔ
də	d ə
dɛ	d ɛ
dʊ	d ʊ
d̪abbʰo	d̪ a b b o
d̠ad̠	d a d
d̪aja	d̪ a j a
d̪al	d̪ a l
d̪æll	d̪ æ l l
d̪an	d̪ a n
d̪and̪aka	d̪ a n d̪ a k a
d̪an̪	d̪ a n 
dʰan̪a	d a n  a
d̪an̪a	d̪ a n  a
d̪arb	d̪ a ɾ b
dɑdɑ	d ɑ d ɑ
dʲeːka	dʲ eː k a
dʲeĕtʲ	dʲ e e tʲ
dɔf	d ɔ f
dʐi	d ʒ i
dɾiʔɪstəʋeɫ	d ɾ i ʔ ɪ s t ə ʋ e ɫ
dʲiːʒɛ	dʲ iː ʒ ɛ
dɛj	d ɛ j
dɔjɛ	d ɔ j ɛ
d̪jũːn	d̪ j uː n
dăk	d a k
dɑk	d ɑ k
dɛk	d ɛ k
dɑl	d ɑ l
dʌl	d ə l
d̪lan	d̪ l a n
dɛm	d ɛ m
dɛmboɾa	d ɛ m b o ɾ a
dɔməɹ	d ɔ m ə ɹ
dĩneɪ	d i n e ɪ
dɑniu	d ɑ n i u
dɑnɑ	d ɑ n ɑ
dɔnɔ	d ɔ n ɔ
d̪o	d̪ o
dʰoko	d o k o
dɦol	d h o l
d̪oʃi	d̪ o ʃ i
dɑq̠ɑ	d ɑ k ɑ
dɛq̠ə	d ɛ k ə
dɔs	d ɔ s
dɑsɑ̃nɾĩ	d ɑ s ɑ n ɾ i
dɪt	d ɪ t
dɔts	d ɔ t s
dɑtzijɪk	d ɑ t z i j ɪ k
dœtɹ̩	d o t ɹ
dɜt͡ʃä	d ɛ tʃ a
d̪uk	d̪ u k
dŭurs	d u u ɾ s
d̪uðala	d̪ u ð a l a
dʏz	d u z
dɛzimos	d ɛ z i m o s
dɑɾ	d ɑ ɾ
dɑχ	d ɑ f
dɔʔ	d ɔ ʔ
dəʔ	d ə ʔ
dɛɛ	d ɛ ɛ
dɪʉ	d ɪ ʉ
dẽẽ	d e e
dɔ̃	d ɔ
dəɽa	d ə ɹ a
d͡ʒa	dʒ a
d͡ʒãã	dʒ a a
d͡ʒab	dʒ a b
dɑɾad	d ɑ ɾ a d
d͡ʒæh	dʒ æ h
d͡ʒai	dʒ a i
d̪ʒak	d̪ ʒ a k
d͡ʒamʌʔa	dʒ a m ə ʔ a
d͡ʒana	dʒ a n a
d͡ʒand͡ʒ	dʒ a n dʒ
d͡ʒar	dʒ a ɾ
d̠ʒara	d ʒ a ɾ a
d͡ʒarː	dʒ a ɾ
d͡ʒaw	dʒ a w
d͡ʒaɭ	dʒ a ɫ
d͡ʒaɾa	dʒ a ɾ a
d͡ʒaɾi	dʒ a ɾ i
d͡ʒaːt̪əka	dʒ aː t̪ ə k a
d͡ʒaːɾa	dʒ aː ɾ a
d͡ʒæŋɢʲ	dʒ æ ŋ ɡ
d̪ɪbb	d̪ ɪ b b
d͡ʒe	dʒ e
dʲĕedʲeː	dʲ e e dʲ eː
d͡ʒenː	dʒ e n
d͡ʒeːnu	dʒ eː n u
d͡ʒhaɻɖ	dʒ h a ɹ ɖ
dɪɬhɪɬ	d ɪ ɫ h ɪ ɫ
d͡ʒi	dʒ i
d͡ʒibi	dʒ i b i
d͡ʒikʼa	dʒ i k a
d͡ʒin	dʒ i n
d͡ʒiq̠i	dʒ i k i
də̟i̯	d ə i
d͡ʒiːkʰa	dʒ iː kʰ a
dɨŋk	d ɪ ŋ k
dɑːl	d ɑː l
d͡ʒlelee	dʒ l e l e e
dɑːlum	d ɑː l u m
dʲɛlɔ	dʲ ɛ l ɔ
dɑχləχ	d ɑ f l ə f
d͡ʒõ	dʒ o
d͡ʒoŋ	dʒ o ŋ
dẽŋq̠amlə	d e ŋ k a m l ə
dɛːr	d ɛ ɾ
d̪ɒrɒsɒ	d̪ ɒ ɾ ɒ s ɒ
dɾɛte̥	d ɾ ɛ t e
d̪ɪuja	d̪ ɪ u j a
dĩɛɛ	d i ɛ ɛ
dɛ̃ẽ	d ɛ e
d͡ʒʲætʲ	dʒ æ tʲ
d͡ʒăazas	dʒ a a z a s
d͡ʒɑdi	dʒ ɑ d i
dɾɑŋk	d ɾ ɑ ŋ k
dɑːχləks	d ɑː f l ə k s
d͡ʒɛm	dʒ ɛ m
d͡ʒɑmil	dʒ ɑ m i l
d͡ʒɑn	dʒ ɑ n
d̪̤ɦo	d h o
d͡ʒʰodi	dʒ o d i
d̪̤ɦol	d h o l
d̪̤ɦona	d h o n a
d͡ʒʌq̠q̠a	dʒ ə k k a
d͡ʒɛs	dʒ ɛ s
dɛ̃ɛ̃	d ɛ ɛ
d̪ɒɾɒsɒ	d̪ ɒ ɾ ɒ s ɒ
d͡ʒʰʌɾi	dʒ ə ɾ i
d͡ʒɛɡɛɛ	dʒ ɛ ɡ ɛ ɛ
e	e
eba	e b a
ebe	e b e
ebee	e b e e
ebeemʉd	e b e e m ʉ d
ebeemʉr	e b e e m ʉ ɾ
ebeepeme	e b e e p e m e
ebeetir	e b e e t i ɾ
ebepeme	e b e p e m e
ebere	e b e ɾ e
ebla	e b l a
ebun	e b u n
ebɛ	e b ɛ
eçeɹe	e ç e ɹ e
edaba	e d a b a
edro	e d ɾ o
edɔ	e d ɔ
ed̪a	e d̪ a
edɥo	e d w o
edʑre	e d ʒ ɾ e
edɪɪ	e d ɪ ɪ
ed̠ʑa	e d ʒ a
ed̠ʑʷa	e d ʒ a
ee	e e
eferi	e f e ɾ i
eflẽ	e f l e
efo	e f o
efũ	e f u
ehã	e h a
ehani	e h a n i
ehe	e h e
ehlɔ	e h l ɔ
eiːɣa	e iː ɡ a
eja	e j a
ejra	e j ɾ a
eka	e k a
ekpe	e k p e
ekpo	e k p o
ekʷa	e kʷ a
ek͡pa	e kp a
ekɔ̃	e k ɔ
ela	e l a
elaa	e l a a
elak	e l a k
elaq̠	e l a k
ele	e l e
elipeme	e l i p e m e
elo	e l o
elolo	e l o l o
elöö	e l o o
elu	e l u
elɯ	e l ʊ
elɛe	e l ɛ e
el̥ta	e l t a
elɯ̈ɯ̈	e l ʊ ʊ
ema	e m a
emab	e m a b
emak	e m a k
emana	e m a n a
emap	e m a p
emaɡ	e m a ɡ
embesat	e m b e s a t
emlã	e m l a
emɾaz	e m ɾ a z
ena	e n a
enaɡ	e n a ɡ
enimederə	e n i m e d e ɾ ə
enimetulə	e n i m e t u l ə
enimɛda	e n i m ɛ d a
enimɛta	e n i m ɛ t a
enyɔ	e n i ɔ
enɢelab	e n ɡ e l a b
en̠jɛ	e n j ɛ
en̪ẽ	e n  e
epelipe	e p e l i p e
eq̠	e k
eq̠ã	e k a
eq̠ba	e k b a
eq̠ɔi	e k ɔ i
esa	e s a
esib	e s i b
esrɔ̃	e s ɾ ɔ
esterio	e s t e ɾ i o
eta	e t a
etaʒə	e t a ʒ ə
ete	e t e
eteɲa	e t e ɲ a
etu	e t u
etɪ	e t ɪ
et̠ɕa	e t ʃ a
et͡ʃaŋq̠we	e tʃ a ŋ k w e
et̠ɕo	e t ʃ o
et͡ʃo	e tʃ o
et̠ɕri	e t ʃ ɾ i
et̠ɕʷa	e t ʃ a
et̠ɕʷo	e t ʃ o
euskaɾa	e u s k a ɾ a
eva	e v a
eve	e v e
evlo	e v l o
ewa	e w a
ewe	e w e
eweebi	e w e e b i
ewel	e w e l
ewlɔ	e w l ɔ
ewu	e w u
ewɔ	e w ɔ
exe	e f e
eza	e z a
eðer	e ð e ɾ
eː	eː
eŋa	e ŋ a
eɕa	e ʃ a
eɖa	e ɖ a
eɣa	e ɡ a
eɲa	e ɲ a
eɸa	e ɸ a
eɾa	e ɾ a
eʋa	e ʋ a
eŋak	e ŋ a k
eɹaɹe	e ɹ a ɹ e
eɡbeleɡbe	e ɡ b e l e ɡ b e
eːdɛʃ	eː d ɛ ʃ
eŋe	e ŋ e
eɓe	e b e
eʍe	e w e
eʋel	e ʋ e l
eɥerela	e w e ɾ e l a
eɡho	e ɡ h o
eɣiŋq̠oðu	e ɡ i ŋ k o ð u
eɣla	e ɡ l a
eɸle	e ɸ l e
eŋlɔ	e ŋ l ɔ
eɡlɔ̃	e ɡ l ɔ
eŋmo	e ŋ m o
eʋoro	e ʋ o ɾ o
eɪq̠	e ɪ k
eːq̠ɛt	eː k ɛ t
eɛre	e ɛ ɾ e
eɲrẽ	e ɲ ɾ e
eːsːɛl	eː s ɛ l
eːtu	eː t u
eɪtə	e ɪ t ə
eɕʷa	e ʃ a
eɡ͡bo	e ɡb o
eɪɲuwæ	e ɪ ɲ u w æ
fa	f a
faa	f a a
faba	f a b a
fai	f a i
faifai	f a i f a i
faka	f a k a
fækkərə	f æ k k ə ɾ ə
fækərə	f æ k ə ɾ ə
falɛna	f a l ɛ n a
falɑq̠u	f a l ɑ k u
fãn	f a n
far	f a ɾ
fas	f a s
fæsl̥	f æ s l
fassələ	f a s s ə l ə
fasələ	f a s ə l ə
fauː	f a uː
fazɛ	f a z ɛ
faː	f aː
faɲa	f a ɲ a
fæʃal	f æ ʃ a l
fæːd̪i	f æ d̪ i
faːi	f aː i
faʔir	f a ʔ i ɾ
faːja	f aː j a
faɪjəan	f a ɪ j ə a n
faŋk	f a ŋ k
faːla	f aː l a
fãːma	f aː m a
faːr	f aː ɾ
faːt͡ʃ	f aː tʃ
faːza	f aː z a
faːə	f aː ə
fæʃʃal	f æ ʃ ʃ a l
fæχχam	f æ f f a m
faʔʔar	f a ʔ ʔ a ɾ
faːɗi	f aː d  i
fæχʌm	f æ f ə m
faχʌt̪	f a f ə t̪
fekɾ	f e k ɾ
fel̪u	f e l u
feðe	f e ð e
feðɹ̩	f e ð ɹ
ffumu	f f u m u
fiali	f i a l i
fil	f i l
fili	f i l i
fimtɪ	f i m t ɪ
firifirii	f i ɾ i f i ɾ i i
fiɔn	f i ɔ n
fiɛːɹ	f i ɛ ɹ
flɑsq̠ə	f l ɑ s k ə
føː	f o
frʌk	f ɾ ə k
ft	f t
fui	f u i
fuːl̪	f uː l
fwaːr	f w aː ɾ
fwɛ	f w ɛ
fyr	f i ɾ
fɾai	f ɾ a i
fɾansa	f ɾ a n s a
fɾaŋku̥	f ɾ a ŋ k u
fɾaŋq̠u̥	f ɾ a ŋ k u
fɾis	f ɾ i s
fɔj	f ɔ j
fɛl	f ɛ l
fɔlk	f ɔ l k
fɔn	f ɔ n
fən	f ə n
fɛn	f ɛ n
fœnː	f o n
fɔnʲɛma	f ɔ ɲ ɛ m a
fɛre	f ɛ ɾ e
fɛrɛfɛrɛ	f ɛ ɾ ɛ f ɛ ɾ ɛ
fɑt	f ɑ t
fɛt	f ɛ t
fɪto	f ɪ t o
fɒx	f ɒ f
fʲzʲjɔloɡas	fʲ z j ɔ l o ɡ a s
fɑʁ	f ɑ f
fəʔ	f ə ʔ
fɛɟ	f ɛ ɟ
fʌχ	f ə f
fəɽa	f ə ɹ a
fʌɗi	f ə d  i
fʌʃi	f ə ʃ i
fɛ̃kʲiɲ	f ɛ k i ɲ
fɤːləm	f ʊ l ə m
fœːn	f oː n
fɑɾsi	f ɑ ɾ s i
fɑʔɜr	f ɑ ʔ ɛ ɾ
fɾɑɲə	f ɾ ɑ ɲ ə
ha	h a
hacca	h a c c a
hæd̪d̪əmə	h æ d̪ d̪ ə m ə
hæd̪əm	h æ d̪ ə m
hæd̪əmə	h æ d̪ ə m ə
hahcu	h a h c u
haheɪ	h a h e ɪ
hai	h a i
hajd̪uk	h a j d̪ u k
hak	h a k
haka	h a k a
hakyuk	h a k i u k
hal	h a l
hala	h a l a
hallalaʔ	h a l l a l a ʔ
hælɒ	h æ l ɒ
hælɒbɒ	h æ l ɒ b ɒ
hæmil	h æ m i l
hæmisə	h æ m i s ə
hamsə	h a m s ə
haməɾ	h a m ə ɾ
hana	h a n a
hænni	h æ n n i
hænnə	h æ n n ə
hænə	h æ n ə
haos	h a o s
hap	h a p
hæpeɪ	h æ p e ɪ
hapihapi	h a p i h a p i
hæpʷeɪ	h æ pʷ e ɪ
haq̠ə	h a k ə
harmoːnʲja	h a ɾ m oː ɲ j a
harr	h a ɾ ɾ
hasn	h a s n
hats	h a t s
haud̪u	h a u d̪ u
hauː	h a uː
hawaw	h a w a w
hazɔl	h a z ɔ l
hazːɔl	h a z ɔ l
haððɜr	h a ð ð ɛ ɾ
haβ	h a v
haŋan	h a ŋ a n
haːd̪i	h aː d̪ i
haβeʎβadz	h a v e ʎ v a d z
haːi	h aː i
haβidjan	h a v i d j a n
ha̠k	h a k
ha̠kcu	h a k c u
haːlu	h aː l u
haːv	h aː v
haːva	h aː v a
haʊwwə	h a ʊ w w ə
haʊwə	h a ʊ w ə
haɲː	h a ɲ
haːŋ	h aː ŋ
hdn	h d n
hefɑzat	h e f ɑ z a t
heje	h e j e
hekɑjat	h e k ɑ j a t
hekʷʼ	h e kʷ
hema	h e m a
hemo	h e m o
heɸk	h e ɸ k
hi	h i
himbæ	h i m b æ
hitca̠	h i t c a
hittibdup	h i t t i b d u p
hiwɑ̝	h i w ɑ
hiyawt	h i i a w t
hiɫwoʒ	h i ɫ w o ʒ
hiŋxɔk	h i ŋ f ɔ k
hiːə	h iː ə
hiʈʈu	h i ʈ ʈ u
hiːə̃n	h iː ə n
hjɛːr	h j ɛ ɾ
hol	h o l
horopɑ	h o ɾ o p ɑ
hots	h o t s
hot̪	h o t̪
hoza	h o z a
ho̰	h o
høː	h o
ho˞e˞	h ɚ ɚ
hoŋko	h o ŋ k o
hoŋon	h o ŋ o n
htøn	h t o n
htøːn	h t o n
hu	h u
hui	h u i
huiə	h u i ə
hukiɑ	h u k i ɑ
huomen	h u o m e n
husːə	h u s ə
huy	h u i
huː	h uː
hu˞	h ɚ
huʔi	h u ʔ i
huːvu	h uː v u
hwie	h w i e
hwɔ	h w ɔ
hwɛ	h w ɛ
hɔ	h ɔ
hœbn̥	h o b n
hũca	h u c a
hɔd	h ɔ d
hɔdː	h ɔ d
hʌd͡ʒ	h ə dʒ
hɔiʔ	h ɔ i ʔ
hʏiːjz	h u iː j z
hɑjɑʒĩ	h ɑ j ɑ ʒ i
hɛkɑn	h ɛ k ɑ n
hɑl	h ɑ l
hʌlli	h ə l l i
hɑlɑ	h ɑ l ɑ
hʲmnas	h m n a s
hɑmɾɑhɑn	h ɑ m ɾ ɑ h ɑ n
hən	h ə n
hɛpːɪn	h ɛ p ɪ n
hɑr	h ɑ ɾ
h̩redor	h ɾ e d o ɾ
hɛspa	h ɛ s p a
hɛstʏr	h ɛ s t u ɾ
hɪsːa	h ɪ s a
hăt	h a t
hɑt̪ʰ	h ɑ tʰ
hɑwɑnq̠	h ɑ w ɑ n k
həxpʰaanl	h ə f pʰ a a n l
hʏxsa	h u f s a
həŋ	h ə ŋ
h̩ŋ	h ŋ
hɔɾantçeʎ	h ɔ ɾ a n t ç e ʎ
hɑɹdɑn	h ɑ ɹ d ɑ n
h̩ɾed	h ɾ e d
hɛːfɛ	h ɛ f ɛ
hɑːnʌt	h ɑː n ə t
hɑŋoɯp	h ɑ ŋ o ʊ p
hɑːq̠ɑs	h ɑː k ɑ s
hɛːr	h ɛ ɾ
hɑ̃soti	h ɑ s o t i
hɪʃtl̥ɪʃ	h ɪ ʃ t l ɪ ʃ
həʂʌ	h ə ʃ ə
həʃʌ	h ə ʃ ə
hʏːɣa	h uː ɡ a
hʌɭɭi	h ə ɫ ɫ i
hɑŋəɾ	h ɑ ŋ ə ɾ
i	i
ia	i a
iabadʑəʁ	i a b a d ʒ ə f
iadʑan	i a d ʒ a n
iam	i a m
ian	i a n
iau	i a u
iaʔ	i a ʔ
iaɾə	i a ɾ ə
iba	i b a
ibe	i b e
ibhja	i b h j a
ibi	i b i
ibiru	i b i ɾ u
ibja	i b j a
ibje	i b j e
ibo	i b o
ide	i d e
idhje	i d h j e
idi	i d i
idindi	i d i n d i
idje	i d j e
ido	i d o
idoko	i d o k o
idɔma	i d ɔ m a
id͡ʒa	i dʒ a
id͡ʒe	i dʒ e
id̠ʒʷo	i d ʒ o
ihi	i h i
ihu	i h u
iima	i i m a
ija	i j a
ijaː	i j aː
ijinum	i j i n u m
ijo	i j o
ijot	i j o t
ijupɛr	i j u p ɛ ɾ
ijɛq̠	i j ɛ k
ika	i k a
ikha	i k h a
ikinabɔ	i k i n a b ɔ
iko	i k o
ikoko	i k o k o
ikpukpu	i k p u k p u
ikwa	i k w a
ili	i l i
ilo	i l o
ilɛi	i l ɛ i
ima	i m a
imi	i m i
imiti	i m i t i
in	i n
infinitiːvi	i n f i n i t iː v i
inoa	i n o a
inwɛn	i n w ɛ n
inɑ	i n ɑ
inɔ	i n ɔ
inʃiku	i n ʃ i k u
inʃita	i n ʃ i t a
ioʔ	i o ʔ
iõŋ	i o ŋ
ipa	i p a
ipha	i p h a
ipi	i p i
ipja	i p j a
ipootukpo	i p o o t u k p o
ipus	i p u s
ipʰo	i pʰ o
iqqaz	i k k a z
iq̠mũ	i k m u
iq̠ɔ	i k ɔ
iri	i ɾ i
irik	i ɾ i k
iriq̠	i ɾ i k
isa	i s a
isja	i s j a
ism	i s m
istq̠ɑh	i s t k ɑ h
ita	i t a
ite	i t e
ithe	i t h e
itloq̠	i t l o k
itodo	i t o d o
itodɛbɛ	i t o d ɛ b ɛ
itsɑɬq̠ai	i t s ɑ ɫ k a i
itu	i t u
itʰo	i tʰ o
iuʁi	i u f i
ivaho	i v a h o
ivu	i v u
iwe	i w e
iw̃a	i w a
ixbɑɹ	i f b ɑ ɹ
ixf	i f f
iyaʔ	i i a ʔ
izo	i z o
izoːkʰoma	i z oː kʰ o m a
izoːkʰoːma	i z oː kʰ oː m a
izu	i z u
iz̃u	i z u
iɪ	i ɪ
iʔ	i ʔ
iː	iː
iɡa	i ɡ a
iɲa	i ɲ a
iɗana	i d  a n a
iɡbi	i ɡ b i
iədzan	i ə d z a n
iʃiiisii	i ʃ i i i s i i
iɟira	i ɟ i ɾ a
iœjʁnə	i o j f n ə
iʔloq̠	i ʔ l o k
iːmæn	iː m æ n
iːr	iː ɾ
iĭspuːdʲs	i i s p uː dʲ s
iʊss	i ʊ s s
iːstʲɾʲʒʲă	iː s tʲ ɾʲ ʒ a
iʃta	i ʃ t a
iŋu	i ŋ u
iṽu	i v u
i˞u	ɚ u
iɔʔ	i ɔ ʔ
iəʔ	i ə ʔ
iʌɯ	i ə ʊ
iʒə	i ʒ ə
iɡ͡baɡ͡ba	i ɡb a ɡb a
iʃɑn	i ʃ ɑ n
ja	j a
jã	j a
jaa	j a a
jaaŋ	j a a ŋ
jæhd̪ʊm	j æ h d̪ ʊ m
jaja	j a j a
jajaʔ	j a j a ʔ
jæjɛn	j æ j ɛ n
jaka	j a k a
jakʷʼa	j a kʷ a
jæmə	j æ m ə
jana	j a n a
janatata	j a n a t a t a
janoːstătoːs	j a n oː s t a t oː s
jarcud	j a ɾ c u d
jarħas	j a ɾ h a s
jarɛd	j a ɾ ɛ d
jau	j a u
jaukt	j a u k t
jauː	j a uː
jaɟa	j a ɟ a
jæχd̪ʊm	j æ f d̪ ʊ m
jaːk	j aː k
jaːke	j aː k e
jaːnaman	j aː n a m a n
jaːta	j aː t a
jaɡ͡ba	j a ɡb a
jæħəd̪ʊθ	j æ h ə d̪ ʊ θ
jela	j e l a
jelat͡ɬ	j e l a tʃ
jeli	j e l i
jelna	j e l n a
jelo	j e l o
jenne	j e n n e
jennʌ	j e n n ə
jen̪n̪ʌ	j e n  n  ə
jerantʰ	j e ɾ a n tʰ
jesməʃakmənei	j e s m ə ʃ a k m ə n e i
jeɣbair	j e ɡ b a i ɾ
jeʁil	j e f i l
jeɾt͡ʃaniq̠	j e ɾ tʃ a n i k
ji	j i
jidɪɬɪkʰ	j i d ɪ ɫ ɪ kʰ
jireŋ	j i ɾ e ŋ
jit	j i t
jiɑ̃ɬ	j i ɑ ɫ
jodlɑ̃	j o d l ɑ
jommo	j o m m o
jomo	j o m o
jøn	j o n
jotʰʌ	j o tʰ ə
jouːl	j o uː l
jowi	j o w i
js	j s
jukʰ	j u kʰ
juo	j u o
juu	j u u
juɫ	j u ɫ
juʒipa	j u ʒ i p a
juʃtã	j u ʃ t a
jɑ	j ɑ
jɛ	j ɛ
jəktɯbu	j ə k t ʊ b u
jɔm	j ɔ m
jɛm	j ɛ m
jɛmɑx	j ɛ m ɑ f
jən	j ə n
jŏos	j o o s
jɑq̠jɑq̠	j ɑ k j ɑ k
jɑt̪mɑx	j ɑ t̪ m ɑ f
jɪzɪshĩ	j ɪ z ɪ s h i
jɛɛ	j ɛ ɛ
jɑːbi	j ɑː b i
j̤ɦelna	j h e l n a
jə̟i̯	j ə i
jɛɹt̪l̩mɑx	j ɛ ɹ t̪ l m ɑ f
ka	k a
kã	k a
kaa	k a a
kãã	k a a
kabaju	k a b a j u
kabanan	k a b a n a n
kabɫ̩	k a b ɫ̩
kada	k a d a
kadon	k a d o n
kae	k a e
kafat	k a f a t
kafaŋlen	k a f a ŋ l e n
kafe	k a f e
kafːɪ	k a f  ɪ
kahi	k a h i
kaiki	k a i k i
kaimɛnɔs	k a i m ɛ n ɔ s
kairan	k a i ɾ a n
kaiʔ	k a i ʔ
kaj	k a j
kakaptan	k a k a p t a n
kakwa	k a k w a
kal	k a l
kala	k a l a
kalã	k a l a
kalãã	k a l a a
kalaː	k a l aː
kalb	k a l b
kali	k a l i
kalta	k a l t a
kaltas	k a l t a s
kal̥o	k a l o
kam	k a m
kãm	k a m
kama	k a m a
kamaraʔ	k a m a ɾ a ʔ
kamatis	k a m a t i s
kæmmal	k æ m m a l
kammi	k a m m i
kampanː	k a m p a n
kamʲpʲɛ̞	k a mʲ pʲ ɛ
kana	k a n a
kanap	k a n a p
kani	k a n i
kanːa	k a n a
kap	k a p
kara	k a ɾ a
kartʲs	k a ɾ tʲ s
kæssərə	k æ s s ə ɾ ə
kæsərə	k æ s ə ɾ ə
kasɪ̥	k a s ɪ
kasʃː	k a s ʃ
katon	k a t o n
katumatːomasta	k a t u m a t o m a s t a
katʰ	k a tʰ
kãtʰ	k a tʰ
kau	k a u
kauhea	k a u h e a
kauran	k a u ɾ a n
kauː	k a uː
kaza	k a z a
kazu	k a z u
kazː	k a z
kazəs	k a z ə s
kãŋ	k a ŋ
kæʃ	k æ ʃ
kaː	k aː
kaʔa	k a ʔ a
kaɲalo	k a ɲ a l o
kaɾaŋq̠jɔzi	k a ɾ a ŋ k j ɔ z i
ka˞e˞	k ɚ ɚ
ka̤h	k a h
ka̤iʔ	k a i ʔ
kaːla	k aː l a
kaĭmas	k a i m a s
kæ̃n̪o	k æ n  o
kaɖo	k a ɖ o
kaːpod	k aː p o d
kaːsu	k aː s u
kaʃu	k a ʃ u
kæ̃ŋ	k æ ŋ
kaŋɡa	k a ŋ ɡ a
kaːət	k aː ə t
kaːɾu	k aː ɾ u
kaʊ̃ŋ	k a ʊ ŋ
kaːʒɛ	k aː ʒ ɛ
keiden	k e i d e n
ketɑb	k e t ɑ b
keula	k e u l a
keːjə	k eː j ə
keːkeːb	k eː k eː b
keːkeːbː	k eː k eː b
keːpa	k eː p a
keːpʰ	k eː pʰ
keːpɛn	k eː p ɛ n
keːpʰː	k eː pʰ
keːpːɛːn	k eː p ɛ n
keɾu	k e ɾ u
keːɾu	k eː ɾ u
keɛːðə	k e ɛ ð ə
khaɖo	k h a ɖ o
khɯl̥ɯ	k h ʊ l ʊ
kibda̠ʔ	k i b d a ʔ
kifumu	k i f u m u
kihanaʔ	k i h a n a ʔ
kilo	k i l o
kimo	k i m o
kipi	k i p i
kisa	k i s a
kisiu	k i s i u
kisːa	k i s a
kitik	k i t i k
kiuru	k i u ɾ u
kivu	k i v u
kiwi	k i w i
kiɖi	k i ɖ i
kiːp	k iː p
kiːpoː	k iː p oː
kiːt	k iː t
kiːt̪a	k iː t̪ a
ki̤ːt	k i t
kiʕʷəm	k i ɹ ə m
kkamci	k k a m c i
kkapa	k k a p a
kkazi	k k a z i
klad̪a	k l a d̪ a
klaʕənksusən	k l a ɹ ə n k s u s ə n
kmeːŋ	k m eː ŋ
kn	k n
kneːz	k n eː z
knjyʔ	k n j i ʔ
ko	k o
kod̪	k o d̪
koh	k o h
koiran	k o i ɾ a n
koj	k o j
kojju	k o j j u
kokat̪u	k o k a t̪ u
koko	k o k o
kolons	k o l o n s
koloo	k o l o o
kompaɲə	k o m p a ɲ ə
kõn	k o n
konin	k o n i n
konkani	k o n k a n i
konə	k o n ə
koq̠a	k o k a
kore	k o ɾ e
korːe	k o ɾ e
kour	k o u ɾ
kourin	k o u ɾ i n
kouː	k o uː
kouːl	k o uː l
køyden	k o i d e n
koː	k oː
ko˞e˞	k ɚ ɚ
koŋin	k o ŋ i n
koːkoː	k oː k oː
koːnə	k oː n ə
køːrɛ	k o ɾ ɛ
koʔu	k o ʔ u
koɣɫ̩	k o ɡ ɫ̩
kpikpiki	k p i k p i k i
kpkipmul	k p k i p m u l
kraːkŋ	k ɾ aː k ŋ
kra̤kŋ	k ɾ a k ŋ
kreer	k ɾ e e ɾ
krei	k ɾ e i
kreyo	k ɾ e i o
kro̤ːh	k ɾ oː h
krtʲ	k ɾ tʲ
krɔnmɔ̃k	k ɾ ɔ n m ɔ k
krɔ̤h	k ɾ ɔ h
kua	k u a
kubba	k u b b a
kudda	k u d d a
kufa	k u f a
kuiden	k u i d e n
kul	k u l
kulima	k u l i m a
kuliɾa	k u l i ɾ a
kulta	k u l t a
kuləɹ	k u l ə ɹ
kunup	k u n u p
kunũ	k u n u
kuorin	k u o ɾ i n
kuovi	k u o v i
kupipira	k u p i p i ɾ a
kupiː	k u p iː
kuq̠q̠uɾa	k u k k u ɾ a
kuq̠ula	k u k u l a
kuraːsəton	k u ɾ aː s ə t o n
kurɑ	k u ɾ ɑ
kurʊ	k u ɾ ʊ
kur̥	k u ɾ
kusa	k u s a
kusaza	k u s a z a
kusina	k u s i n a
kussa	k u s s a
kuta	k u t a
kutsaraʔ	k u t s a ɾ a ʔ
kutta	k u t t a
kutula	k u t u l a
kuva	k u v a
kuwaβa	k u w a v a
kuwera	k u w e ɾ a
kuwola	k u w o l a
kuzaza	k u z a z a
kuɑ	k u ɑ
kuʀ	k u ɾ
kuβa	k u v a
kuɖi	k u ɖ i
kuɽi	k u ɹ i
kuβiβira	k u v i v i ɾ a
kuːtub	k uː t u b
kuːɖi	k uː ɖ i
kuə̯p	k u ə p
kvaːr	k v aː ɾ
kvʌ̃nə	k v ə n ə
kw	k w
kwa	k w a
kwan	k w a n
kwɑ	k w ɑ
kwən	k w ə n
kxapən	k f a p ə n
kya	k i a
kyden	k i d e n
kyn	k i n
kyːn	k i n
kɔ	k ɔ
kʰa	kʰ a
kʰabə	kʰ a b ə
kʰad	kʰ a d
kʰal	kʰ a l
kʰala	kʰ a l a
kʲæltʲ	k æ l tʲ
kʰælɒ	kʰ æ l ɒ
kʰæl̪ɒ	kʰ æ l ɒ
kʷama	kʷ a m a
kʰãmja	kʰ a m j a
kʰan	kʰ a n
kʁanta	k f a n t a
kʷara	kʷ a ɾ a
kʰar̥	kʰ a ɾ
kʷatsə	kʷ a t s ə
kʰava	kʰ a v a
kʰavo	kʰ a v o
kʰaɹ	kʰ a ɹ
kʲæ̆æslas	k æ æ s l a s
kʲæ̆æsʲtʲ	k æ æ ʃ tʲ
kʷaχua	kʷ a f u a
kʰa̰ʔ	kʰ a ʔ
kʰaːʃi	kʰ aː ʃ i
kɑbɑb	k ɑ b ɑ b
kɔbːɪ	k ɔ b ɪ
kʰe	kʰ e
kʰetekʰe	kʰ e t e kʰ e
kʲeĕslas	k e e s l a s
kɑh	k ɑ h
kɔh	k ɔ h
kʌh	k ə h
kăhiː	k a h iː
kăhĩ	k a h i
kʰi	kʰ i
kʰiau	kʰ i a u
kɲiq̠a	k ɲ i k a
kʰita	kʰ i t a
kʰiːɾu	kʰ iː ɾ u
kəkəmuyaʔ	k ə k ə m u i a ʔ
kɛl	k ɛ l
kɔla	k ɔ l a
kʌli	k ə l i
kʰli	kʰ l i
kɔlii	k ɔ l i i
kăltas	k a l t a s
kɔlɔniʊls	k ɔ l ɔ n i ʊ l s
kɔlɔɔ	k ɔ l ɔ ɔ
kɔlɛɛ	k ɔ l ɛ ɛ
kɑm	k ɑ m
kɔm	k ɔ m
kəm	k ə m
kʰma	kʰ m a
kəmal	k ə m a l
kəmiɽa	k ə m i ɹ a
kămjor	k a m j o ɾ
kămpas	k a m p a s
kɔmːa	k ɔ m a
kɑmʌt	k ɑ m ə t
kʌməɽa	k ə m ə ɹ a
kɑn	k ɑ n
kɔn	k ɔ n
kən	k ə n
kẽnnõŋ	k e n n o ŋ
kɔnɔ	k ɔ n ɔ
kʰo	kʰ o
kʰobor	kʰ o b o ɾ
kʰol	kʰ o l
kʼor	k o ɾ
kʰoɛɹ	kʰ o ɛ ɹ
kɑp	k ɑ p
kɛpa	k ɛ p a
k͡pa	kp a
k͡pak͡pakuʁu	kp a kp a k u f u
kʰpuə	kʰ p u ə
k͡pɔ	kp ɔ
k͡pəɽa	kp ə ɹ a
kɑr	k ɑ ɾ
kărdas	k a ɾ d a s
kăre	k a ɾ e
kɔrhɑ	k ɔ ɾ h ɑ
kʲrtʲ	k ɾ tʲ
kărtʲs	k a ɾ tʲ s
kɔrxɑl	k ɔ ɾ f ɑ l
kărẽ	k a ɾ e
kʊrʊ	k ʊ ɾ ʊ
kʌr̟i	k ə ɾ i
kʌr̠i	k ə ɾ i
kɛrənsjɔza	k ɛ ɾ ə n s j ɔ z a
kɔrɔɔ	k ɔ ɾ ɔ ɔ
kɑsi	k ɑ s i
kɛt	k ɛ t
kɑtɑɯ	k ɑ t ɑ ʊ
kʰt͡ʃu	kʰ tʃ u
kʰt͡ʃɑl	kʰ tʃ ɑ l
kĩu	k i u
kʃu	k ʃ u
kʼu	k u
kʰub	kʰ u b
kʰudaβa	kʰ u d a v a
kʰud͡ʒa	kʰ u dʒ a
kʰujaβa	kʰ u j a v a
kʰul	kʰ u l
kʰumama	kʰ u m a m a
kʰunaq̠a	kʰ u n a k a
kʰupʰ	kʰ u pʰ
kʰuq̠aβa	kʰ u k a v a
kʰutʰ	kʰ u tʰ
kʰuva	kʰ u v a
kʰuw	kʰ u w
kʰuɲaq̠a	kʰ u ɲ a k a
kʰuβaβa	kʰ u v a v a
kʰuɾaːβa	kʰ u ɾ aː v a
kʰuːdza	kʰ uː d z a
kʰuɾeɾa	kʰ u ɾ e ɾ a
kʰuɾiɾa	kʰ u ɾ i ɾ a
kʰuɾoɾa	kʰ u ɾ o ɾ a
kʰuɾq̠waːɾa	kʰ u ɾ k w aː ɾ a
kʰuɾuɾa	kʰ u ɾ u ɾ a
kʰuːʔl	kʰ uː ʔ l
kəviː	k ə v iː
kɑxɫ̩	k ɑ f ɫ̩
kɨy	k ɪ i
kɑzi	k ɑ z i
kɔzin	k ɔ z i n
kəzəs	k ə z ə s
kɑɾ	k ɑ ɾ
kỹɛ	k i ɛ
kɑ̃	k ɑ
kɔː	k ɔ
kʰɔ	kʰ ɔ
kʰʊ	kʰ ʊ
kʰʷ	kʰ
kəɽa	k ə ɹ a
kʷʑa	kʷ ʒ a
kʷʼan	kʷ a n
kʰʷanda	kʰ a n d a
kʰʷanə	kʰ a n ə
kʰʲær̥	kʰ æ ɾ
kʰũat	kʰ u a t
kʰʷatsə	kʰ a t s ə
kʷʼatsʼ	kʷ a t s
kʷʼat͡ʃʼa	kʷ a tʃ a
kɑːdɑɯ	k ɑː d ɑ ʊ
kũɽi	k u ɹ i
kʌɹi	k ə ɹ i
kʰɪkʰa	kʰ ɪ kʰ a
kɑŋkəs	k ɑ ŋ k ə s
kɔːm	k ɔ m
kʰũm	kʰ u m
kɔːma	k ɔ m a
kʰɔmə	kʰ ɔ m ə
kʰən	kʰ ə n
kʰɛn	kʰ ɛ n
kʰʷpsa	kʰ p s a
kɛːs	k ɛ s
kʰɛsibɑ	kʰ ɛ s i b ɑ
kʰɛsɪ	kʰ ɛ s ɪ
kʰɛsəbə	kʰ ɛ s ə b ə
kʰət	kʰ ə t
kʰʷtsʼə	kʰ t s ə
kʌʃt̪a	k ə ʃ t̪ a
kʰɛtʰiðə	kʰ ɛ tʰ i ð ə
kʌɽu	k ə ɹ u
kʲɪuja	k ɪ u j a
kʰʷuə	kʰ u ə
kɪːðə	k ɪ ð ə
kəɾʊ	k ə ɾ ʊ
kʰɔŋ	kʰ ɔ ŋ
kʰəʔ	kʰ ə ʔ
kʰɔː	kʰ ɔ
kʼũː	k uː
kʰɛɾã	kʰ ɛ ɾ a
kʌɖɖi	k ə ɖ ɖ i
kʌɭɭi	k ə ɫ ɫ i
kɔχɛtu̥	k ɔ f ɛ t u
kəɯɾu	k ə ʊ ɾ u
kʰɛɾɒbɒ	kʰ ɛ ɾ ɒ b ɒ
l	l
la	l a
labaa	l a b a a
labuʔ	l a b u ʔ
lafa	l a f a
lahəqq	l a h ə k k
lahɔr	l a h ɔ ɾ
lak	l a k
laki	l a k i
lakʰ	l a kʰ
lakʲtʲ	l a k tʲ
lakʲɛ̞	l a k ɛ
lælama	l æ l a m a
lam	l a m
lamb	l a m b
læmɛʕ	l æ m ɛ ɹ
lana	l a n a
laoɣɾafia	l a o ɡ ɾ a f i a
lap	l a p
lapa	l a p a
lãq̠i	l a k i
lata	l a t a
lat̪o	l a t̪ o
lat̪ũmk	l a t̪ u m k
laupe	l a u p e
lauto	l a u t o
lauː	l a uː
lauːn	l a uː n
lauːna	l a uː n a
laðiːð	l a ð iː ð
laɓa	l a b a
laβa	l a v a
laʕab	l a ɹ a b
laʔbu	l a ʔ b u
laβe	l a v e
læŋkas	l æ ŋ k a s
laːkkʰek	l aː k kʰ e k
laːntsoʃ	l aː n t s o ʃ
laːntsːɔl	l aː n t s ɔ l
laŋoy	l a ŋ o i
laːq̠q̠i	l aː k k i
laɔs	l a ɔ s
laːt̪t̪ʰuka	l aː t̪ tʰ u k a
lãɲə	l a ɲ ə
laːŋ	l aː ŋ
laːɣ	l aː ɡ
laŋɡas	l a ŋ ɡ a s
laːŋq̠ə	l aː ŋ k ə
laʕʕʌb	l a ɹ ɹ ə b
le	l e
lein	l e i n
leit	l e i t
leiːji	l e iː j i
leiːt	l e iː t
lemba	l e m b a
lepasikoruza	l e p a s i k o ɾ u z a
lesu	l e s u
leuhop	l e u h o p
leumak	l e u m a k
levə	l e v ə
ley	l e i
lezu	l e z u
leŋ	l e ŋ
leːd̪	l eː d̪
leːjʊ	l eː j ʊ
lhok	l h o k
liau	l i a u
lidɑɪ	l i d ɑ ɪ
likʊ	l i k ʊ
limɪ	l i m ɪ
linɪ	l i n ɪ
lipɑs	l i p ɑ s
lit	l i t
liːt	l iː t
liːzʌl	l iː z ə l
liɲɪ	l i ɲ ɪ
ljɛtː	l j ɛ t
ljɛːt	l j ɛ t
lo	l o
loar	l o a ɾ
lom	l o m
lompo	l o m p o
lompoa	l o m p o a
lonən	l o n ə n
lote	l o t e
løy	l o i
løː	l o
loːni	l oː n i
lu	l u
luen	l u e n
luk	l u k
lula	l u l a
lulu	l u l u
luo	l u o
lupa	l u p a
luq̠taʔ	l u k t a ʔ
luq̠ɔʃ	l u k ɔ ʃ
luːk	l uː k
luːluː	l uː l uː
luːsːa	l uː s a
lŋ	l ŋ
lɔ	l ɔ
lɛ	l ɛ
l̥a	l a
l̥æm	l æ m
lɪat	l ɪ a t
l̥auːna	l a uː n a
lʲæŋʲkʲmas	l æ ŋ k m a s
lɒbisɒ	l ɒ b i s ɒ
lɑbit	l ɑ b i t
lɑbɑɪɑn	l ɑ b ɑ ɪ ɑ n
l̥ei	l e i
l̥i	l i
l̥i̠	l i
lɑiʕbɒ	l ɑ i ɹ b ɒ
lɔiːjɪ	l ɔ iː j ɪ
lɪiːjɪ	l ɪ iː j ɪ
lɛjʊ	l ɛ j ʊ
lɪjə	l ɪ j ə
lɛk	l ɛ k
lăkas	l a k a s
lɪkʊ	l ɪ k ʊ
lɔkʰ	l ɔ kʰ
lɑlɑ	l ɑ l ɑ
lɛlɛ	l ɛ l ɛ
lɑmboŋ	l ɑ m b o ŋ
ləmp	l ə m p
lɑmpoŋ	l ɑ m p o ŋ
lɑmɑɯ	l ɑ m ɑ ʊ
lɑnɑ	l ɑ n ɑ
l̪oɞa	l o ə a
lɑpʰit	l ɑ pʰ i t
lɛsɛra	l ɛ s ɛ ɾ a
lɔt	l ɔ t
lʌt	l ə t
l̥u	l u
l̥v̩	l v
lɛx	l ɛ f
lɔɔ	l ɔ ɔ
lɔɯ	l ɔ ʊ
ləʔ	l ə ʔ
lɑː	l ɑː
lɔː	l ɔ
lɛ̞	l ɛ
lɯː	l ʊ
l̥ɛ	l ɛ
l̥ɤ	l ʊ
lə̟i̯	l ə i
lɔːk	l ɔ k
lɑŋka	l ɑ ŋ k a
lɑŋq̠on	l ɑ ŋ k o n
lɑŋɑ	l ɑ ŋ ɑ
lɛːŋ	l ɛ ŋ
lɛ̰ʔ	l ɛ ʔ
lɔːɣa	l ɔ ɡ a
lɪːɣa	l ɪ ɡ a
lĩɲə̥	l i ɲ ə
lɛɲə̥	l ɛ ɲ ə
ma	m a
mä	m a
maa	m a a
mada	m a d a
mad̪a	m a d̪ a
mafas	m a f a s
mah	m a h
maha	m a h a
mæha	m æ h a
mai	m a i
mais	m a i s
maja	m a j a
majːa	m a j a
mãk	m a k
mãkonɪs	m a k o n ɪ s
maktɪas	m a k t ɪ a s
makʰa	m a kʰ a
mala	m a l a
malam	m a l a m
mala̘q̠uʔ	m a l a k u ʔ
mäleqʰʷ	m a l e kʰ
mallo	m a l l o
malo	m a l o
mama	m a m a
mamara	m a m a ɾ a
mamaʔ	m a m a ʔ
mamʷeɪ	m a m e ɪ
man	m a n
mæn	m æ n
mana	m a n a
manalas	m a n a l a s
manana	m a n a n a
mana̠ʔ	m a n a ʔ
maneu	m a n e u
maneɪ	m a n e ɪ
mani	m a n i
manna	m a n n a
manoː	m a n oː
mænzel	m æ n z e l
manɛra	m a n ɛ ɾ a
manə̥	m a n ə
manːɪ	m a n ɪ
maqʰa	m a kʰ a
maq̠lutoʔ	m a k l u t o ʔ
maq̠pakulatkaq̠aʔ	m a k p a k u l a t k a k a ʔ
mäqʰʷ	m a kʰ
mar	m a ɾ
mär	m a ɾ
mara	m a ɾ a
martef	m a ɾ t e f
marə	m a ɾ ə
mærəʔ	m æ ɾ ə ʔ
mas	m a s
mata	m a t a
matad	m a t a d
matsʼa	m a t s a
mat̪a	m a t̪ a
matɕʼa	m a t ʃ a
mauː	m a uː
maw	m a w
mawdup	m a w d u p
mawəm	m a w ə m
may	m a i
mazike	m a z i k e
maʔ	m a ʔ
maː	m aː
maʄa	m a ʃ a
maʕa	m a ɹ a
maɟakut	m a ɟ a k u t
mæ̆æs	m æ æ s
maɭe	m a ɫ e
maħfuz	m a h f u z
maħfuð	m a h f u ð
maːki	m aː k i
maːla	m aː l a
maːllo	m aː l l o
maːn	m aː n
maːnako	m aː n a k o
maːsə	m aː s ə
maːtʰẽ	m aː tʰ e
maɖuvu	m a ɖ u v u
ma̠wapa̠	m a w a p a
maːzar	m aː z a ɾ
maɳɔ	m a ɲ  ɔ
maŋɡa	m a ŋ ɡ a
maʈʰa	m a ʈ a
maːʃi	m aː ʃ i
maːɲja	m aː ɲ j a
maːɽu	m aː ɹ u
maɲə̥	m a ɲ ə
mba	m b a
mbaɾa	m b a ɾ a
mbãɲə̥	m b a ɲ ə
mben	m b e n
mbi	m b i
mbo	m b o
mboj	m b o j
mbulei	m b u l e i
mbulim	m b u l i m
mburkɑl	m b u ɾ k ɑ l
mburten	m b u ɾ t e n
mburuu	m b u ɾ u u
mbuslemei	m b u s l e m e i
mbuwen	m b u w e n
mbuŋkɑn	m b u ŋ k ɑ n
mbɔ	m b ɔ
mbɛ	m b ɛ
mbɾasə	m b ɾ a s ə
mbɛŋkei	m b ɛ ŋ k e i
me	m e
mederə	m e d e ɾ ə
medzaniːn	m e d z a n iː n
meidæn	m e i d æ n
meil	m e i l
mela	m e l a
menat	m e n a t
menkhinaskməneŋkʰ	m e n k h i n a s k m ə n e ŋ kʰ
menə	m e n ə
meo	m e o
meoto	m e o t o
mera	m e ɾ a
metulə	m e t u l ə
met̪a	m e t̪ a
meɪ	m e ɪ
meɭ	m e ɫ
meɻ	m e ɹ
meɾ	m e ɾ
meʔatʰ	m e ʔ a tʰ
meɣe	m e ɡ e
meɪhæɾiq̠	m e ɪ h æ ɾ i k
meɪjoqʰ	m e ɪ j o kʰ
me̝ntʁə	m e n t f ə
meːnə	m eː n ə
meɪsɑ	m e ɪ s ɑ
meχɑɾɑm	m e f ɑ ɾ ɑ m
mhe	m h e
mi	m i
mia	m i a
miaka	m i a k a
mider	m i d e ɾ
miida	m i i d a
miita	m i i t a
miitul	m i i t u l
mijaqʷ	m i j a kʷ
mikʰo	m i kʰ o
milmi	m i l m i
milɑːq̠ɾu	m i l ɑː k ɾ u
mirah	m i ɾ a h
misʊliɑ	m i s ʊ l i ɑ
mizatʷʼ	m i z a tʷ
miʔ	m i ʔ
miː	m iː
miːl̪	m iː l
miːm	m iː m
miːn	m iː n
mja	m j a
mjaka	m j a k a
mjaŋa	m j a ŋ a
mjɛ̰̃ʔna	m j ɛ ʔ n a
mla	m l a
mma	m m a
mmaɾa	m m a ɾ a
mmet̠	m m e t
mmula	m m u l a
mmɛ	m m ɛ
mməɬq	m m ə ɫ k
moderə	m o d e ɾ ə
mohɞn	m o h ə n
moi	m o i
mois	m o i s
mona	m o n a
møq̠eː	m o k eː
moqɑm	m o k ɑ m
moq̠ẽ	m o k e
mot	m o t
motulə	m o t u l ə
moːd̪a	m oː d̪ a
mo˞e˞	m ɚ ɚ
mo̠ni̠cu	m o n i c u
møːðə	m o ð ə
mpãã	m p a a
mpai	m p a i
mpaka	m p a k a
mpa̤i	m p a i
mpʰua	m pʰ u a
mpɛɲə̥	m p ɛ ɲ ə
mstʲiːtʲ	m s tʲ iː tʲ
mu	m u
mudæ	m u d æ
muderə	m u d e ɾ ə
mud͡ʒuŋq̠a	m u dʒ u ŋ k a
mujã	m u j a
mujaju	m u j a j u
mukazi	m u k a z i
muokə	m u o k ə
muona	m u o n a
muq̠azi	m u k a z i
muta	m u t a
mutulə	m u t u l ə
mut͡ʃuŋq̠wa	m u tʃ u ŋ k w a
muwi	m u w i
muy	m u i
muziq̠o	m u z i k o
muħ	m u h
muʔ	m u ʔ
muʕ	m u ɹ
muɣa	m u ɡ a
muʎa	m u ʎ a
muːdi	m uː d i
muːta	m uː t a
muːttʌ	m uː t t ə
muɪtə	m u ɪ t ə
muħɾ	m u h ɾ
mwan	m w a n
myøs	m i o s
myr	m i ɾ
mɨ	m ɪ
mʃ	m ʃ
m̩	m
mɹa	m ɹ a
mʷanta	m a n t a
mʉd	m ʉ d
mɔda	m ɔ d a
mɛda	m ɛ d a
mʊda	m ʊ d a
mʌddi	m ə d d i
məderə	m ə d e ɾ ə
mɑdəɾ	m ɑ d ə ɾ
mʊfiːd̪	m ʊ f iː d̪
mʊfɨː	m ʊ f ɪ
mɑl	m ɑ l
mɛla	m ɛ l a
mɔle	m ɔ l e
mɑlɑ	m ɑ l ɑ
məlʊ	m ə l ʊ
mɪlːa	m ɪ l a
məlɑq̠u	m ə l ɑ k u
mɑmi	m ɑ m i
mɑmɑ	m ɑ m ɑ
mĩn	m i n
mən	m ə n
mɨn	m ɪ n
mɪn	m ɪ n
məna	m ə n a
mʌn̪a	m ə n  a
mən̥ɛ̰ʔ	m ə n ɛ ʔ
m̥oʊŋ	m o ʊ ŋ
mɛp	m ɛ p
mɛq̠	m ɛ k
mɔrn	m ɔ ɾ n
mɑsluːb	m ɑ s l uː b
məsluːb	m ə s l uː b
mɔt	m ɔ t
mət	m ə t
mɑta	m ɑ t a
mɔta	m ɔ t a
mɛta	m ɛ t a
mʊta	m ʊ t a
mətulə	m ə t u l ə
mɑtɑ	m ɑ t ɑ
mɑt͡ʃ	m ɑ tʃ
mɛt͡ʃ	m ɛ tʃ
mɔŋ	m ɔ ŋ
məʔ	m ə ʔ
mɪʃ	m ɪ ʃ
mɛ̃	m ɛ
mʌɳa	m ə ɲ  a
məɾe	m ə ɾ e
mɨ̠hca̠dut	m ɪ h c a d u t
mɨ̠hna̠ʔ	m ɪ h n a ʔ
mɑːi̯ŋki	m ɑː i ŋ k i
mɛɛn	m ɛ ɛ n
mɛːr	m ɛ ɾ
məʃə	m ə ʃ ə
məʎʊ	m ə ʎ ʊ
mɔ̃ːk	m ɔ k
mɒħɒlɒ	m ɒ h ɒ l ɒ
mɑ̃ŋə	m ɑ ŋ ə
na	n a
nã	n a
naa	n a a
nabahə	n a b a h ə
næbaħ	n æ b a h
næffəs	n æ f f ə s
næfəs	n æ f ə s
nahi	n a h i
nainĩhi	n a i n i h i
nak	n a k
nala	n a l a
nam	n a m
namta	n a m t a
namŏo	n a m o o
nan	n a n
nasa	n a s a
nasul	n a s u l
nata	n a t a
natʰo	n a tʰ o
natɕʼə	n a t ʃ ə
nauː	n a uː
navaχ	n a v a f
naw	n a w
nawan	n a w a n
nazzam	n a z z a m
næððɜr	n æ ð ð ɛ ɾ
næðɜr	n æ ð ɛ ɾ
naʔ	n a ʔ
nãʊ	n a ʊ
næɲ	n æ ɲ
naɲæh	n a ɲ æ h
naʔal	n a ʔ a l
naʔar	n a ʔ a ɾ
naʔaʀ	n a ʔ a ɾ
naːk	n aː k
naːki	n aː k i
næːmɒ	n æ m ɒ
naːnaː	n aː n aː
næ̟wæ	n æ w æ
næʒə	n æ ʒ ə
naːʃi	n aː ʃ i
nda	n d a
ndeq̠eja	n d e k e j a
ndrikei	n d ɾ i k e i
ndrilɛŋ	n d ɾ i l ɛ ŋ
ndrop	n d ɾ o p
ndrou	n d ɾ o u
ndruwin	n d ɾ u w i n
ndrɑi	n d ɾ ɑ i
ndrɑmei	n d ɾ ɑ m e i
ndwadde	n d w a d d e
ndzuɣd	n d z u ɡ d
nd͡ʒeq̠ere	n dʒ e k e ɾ e
ndɾɛtə	n d ɾ ɛ t ə
ne	n e
neme	n e m e
nemme	n e m m e
neɪ	n e ɪ
neɾs	n e ɾ s
neɪŋ	n e ɪ ŋ
nfirĩfirĩĩ	n f i ɾ i f i ɾ i i
nfumba	n f u m b a
nhe	n h e
niaʔ	n i a ʔ
nie	n i e
nih	n i h
nihni	n i h n i
nikʷʰal	n i kʷ a l
nist	n i s t
niʉ	n i ʉ
niʔ	n i ʔ
niːlɑ	n iː l ɑ
niʃə	n i ʃ ə
njamaŋ	n j a m a ŋ
njata	n j a t a
njeː	n j eː
nköö	n k o o
nkɔlii	n k ɔ l i i
nnana	n n a n a
nnanansi	n n a n a n s i
nnawiyaʔ	n n a w i i a ʔ
nnaɣ	n n a ɡ
nnɛ	n n ɛ
no	n o
nõm	n o m
nombaaldudˀaa	n o m b a a l d u d a a
notranscription	n o t ɾ a n s c ɾ i p t i o n
nou	n o u
now	n o w
noː	n oː
no˞	n ɚ
nøː	n o
noɛmvɾis	n o ɛ m v ɾ i s
noʔu	n o ʔ u
noɛɾos	n o ɛ ɾ o s
npəqmin	n p ə k m i n
nq̠on	n k o n
nsarãsaranĩĩ	n s a ɾ a s a ɾ a n i i
nswa	n s w a
ntsaiː	n t s a iː
ntsa̤iʔ	n t s a i ʔ
ntɛ	n t ɛ
ntɛntə	n t ɛ n t ə
nt̠ɕu	n t ʃ u
ntɔ̃ɔ̃	n t ɔ ɔ
nuai	n u a i
nuhɞtʰ	n u h ə tʰ
numpa	n u m p a
nunɞn	n u n ə n
nuo	n u o
nuŋka	n u ŋ k a
nuːʃ	n uː ʃ
nvuβa	n v u v a
nwɛk	n w ɛ k
nxaʕuləxʷ	n f a ɹ u l ə f
nyt	n i t
nzɛɡɛnɛɛ	n z ɛ ɡ ɛ n ɛ ɛ
nĩ	n i
nɑ	n ɑ
nʲæ	ɲ æ
n̤alɑq̠u	n a l ɑ k u
n̪ao	n  a o
nʲæs	ɲ æ s
nʲæʒdava	ɲ æ ʒ d a v a
nʲæʃʲ	ɲ æ ʃ
nʲæʃʲt͡ʃʲæ	ɲ æ ʃ tʃ æ
n̪aːɽu	n  aː ɹ u
nɛbbah	n ɛ b b a h
nɛbnɛb	n ɛ b n ɛ b
nɑdiɹ	n ɑ d i ɹ
nɑdɑɾ	n ɑ d ɑ ɾ
nəi	n ə i
nɔima	n ɔ i m a
n̩je	n̩ j e
n̥jɛː	n j ɛ
nɔk	n ɔ k
nɛk	n ɛ k
nɨk	n ɪ k
nɛkɜr	n ɛ k ɛ ɾ
nɑlbil	n ɑ l b i l
nɨm	n ɪ m
nɑmɑn	n ɑ m ɑ n
nɔn	n ɔ n
n̪õn̪a	n  o n  a
nɛpnɛp	n ɛ p n ɛ p
nɑq̠ə	n ɑ k ə
n̩t͡ʃõ	n̩ tʃ o
n̩t͡ʃĩ	n̩ tʃ i
n̩t͡ʃɑ	n̩ tʃ ɑ
nɛt͡ʃʌs	n ɛ tʃ ə s
n̪uʔ	n  u ʔ
nɨw	n ɪ w
nɔx	n ɔ f
nɑðar	n ɑ ð a ɾ
nɑɞ	n ɑ ə
nɔŋ	n ɔ ŋ
nəŋ	n ə ŋ
nəʔ	n ə ʔ
nɛʔ	n ɛ ʔ
nɪʃ	n ɪ ʃ
nəɽa	n ə ɹ a
nɾʲiĭtʲ	n ɾʲ i i tʲ
nĩəlɛkaː	n i ə l ɛ k aː
nɑɪnɑɪ	n ɑ ɪ n ɑ ɪ
nɑɯnɑɯ	n ɑ ʊ n ɑ ʊ
nɛʔpʰja	n ɛ ʔ pʰ j a
nɾʲs	n ɾʲ s
nʊ̠t	n ʊ t
n̩ɬt̪eq̠o	n̩ ɫ t̪ e k o
nɑɬt͡ʃɑq̠i	n ɑ ɫ tʃ ɑ k i
nɑʃɹ	n ɑ ʃ ɹ
nɔŋə	n ɔ ŋ ə
nɑɦɛm	n ɑ h ɛ m
nɛ̃ɯnə	n ɛ ʊ n ə
nɛ̰ʔpʰjaŋ	n ɛ ʔ pʰ j a ŋ
n̪ɒħɒbɒ	n  ɒ h ɒ b ɒ
nʃɔɡɔ̃ɔ̃	n ʃ ɔ ɡ ɔ ɔ
obarkidˀii	o b a ɾ k i d i i
obaŋia	o b a ŋ i a
obi	o b i
obo	o b o
obu	o b u
obɔ	o b ɔ
obˀamtii	o b a m t i i
odamja	o d a m j a
odawii	o d a w i i
ode	o d e
odjoo	o d j o o
odo	o d o
ødøn	o d o n
odɔ	o d ɔ
odˀaanike	o d a a n i k e
od̠ʑalii	o d ʒ a l i i
od̠ʒaŋa	o d ʒ a ŋ a
od̠ɥe	o d w e
od̠ʒe	o d ʒ e
ofabˀbii	o f a b b i i
ofaːja	o f aː j a
oforo	o f o ɾ o
oha	o h a
ohaarii	o h a a ɾ i i
ohit	o h i t
ohokʰ	o h o kʰ
ohu	o h u
oja	o j a
ojarii	o j a ɾ i i
ojaːja	o j aː j a
oji	o j i
ojɔn	o j ɔ n
okaria	o k a ɾ i a
okpu	o k p u
okuna	o k u n a
okʷa	o kʷ a
ok͡paːja	o kp aː j a
ok͡pia	o kp i a
olabja	o l a b j a
olati	o l a t i
øljy	o l j i
ølmɑx	o l m ɑ f
olo	o l o
oloonii	o l o o n i i
olvɔʃː	o l v ɔ ʃ
omahii	o m a h i i
omala	o m a l a
omo	o m o
ompa	o m p a
omː	o m
ona	o n a
onaatii	o n a a t i i
onaːja	o n aː j a
ondaarii	o n d a a ɾ i i
oni	o n i
onkin	o n k i n
onuma	o n u m a
oo	o o
opaakpɔtɔibi	o p a a k p ɔ t ɔ i b i
opahia	o p a h i a
opaɣia	o p a ɡ i a
opia	o p i a
opu	o p u
opɛɾə	o p ɛ ɾ ə
oqoqʰ	o k o kʰ
oq̠udæ	o k u d æ
oremii	o ɾ e m i i
orje	o ɾ j e
oro	o ɾ o
øryl	o ɾ i l
orː	o ɾ
osaja	o s a j a
osmaka	o s m a k a
osoodii	o s o o d i i
osu	o s u
ota	o t a
otamja	o t a m j a
otawii	o t a w i i
ots	o t s
otukpa	o t u k p a
otukpo	o t u k p o
ot̠ʃaŋja	o t ʃ a ŋ j a
ot̠ʃe	o t ʃ e
ot͡ʃu	o tʃ u
øuʁopə	o u f o p ə
ovalma	o v a l m a
owarii	o w a ɾ i i
owd͡ʒ	o w dʒ
owe	o w e
owelaa	o w e l a a
owinndii	o w i n n d i i
owoowii	o w o o w i i
owoowiipaaɓiʔepobbi	o w o o w i i p a a b i ʔ e p o b b i
owulii	o w u l i i
oxa	o f a
oxistɔ	o f i s t ɔ
oxmɑx	o f m ɑ f
oxur	o f u ɾ
oy	o i
øz	o z
ozaŋja	o z a ŋ j a
ozi	o z i
oʔ	o ʔ
õŋ	o ŋ
oɲa	o ɲ a
oɲaamii	o ɲ a a m i i
oʔaawii	o ʔ a a w i i
oŋahja	o ŋ a h j a
oɲamja	o ɲ a m j a
oɡaria	o ɡ a ɾ i a
oŋatii	o ŋ a t i i
oɡbudu	o ɡ b u d u
oːbʲælʲs	oː bʲ æ l s
oːdɔ	oː d ɔ
oɡi	o ɡ i
oʃibie	o ʃ i b i e
oʒiozi	o ʒ i o z i
oŋmaja	o ŋ m a j a
oŋmiini	o ŋ m i i n i
oŋmootukpo	o ŋ m o o t u k p o
oŋmumije	o ŋ m u m i j e
oɣo	o ɡ o
oɡooŋdˀii	o ɡ o o ŋ d i i
oːpus	oː p u s
oħrajn	o h ɾ a j n
øːrjøŋq̠	o ɾ j o ŋ k
oːrɔ	oː ɾ ɔ
oħt̪	o h t̪
oβudde	o v u d d e
oβude	o v u d e
øːz	o z
oɹɑdɑn	o ɹ ɑ d ɑ n
oʃɛja	o ʃ ɛ j a
oʒɛja	o ʒ ɛ j a
oʊ̃ŋ	o ʊ ŋ
pa	p a
pã	p a
padjan	p a d j a n
padjoh	p a d j o h
padtʰ	p a d tʰ
pae	p a e
pai	p a i
pais	p a i s
paiʃaja	p a i ʃ a j a
paiɾu	p a i ɾ u
paka	p a k a
pal	p a l
pala	p a l a
paljɔs	p a l j ɔ s
paloʔ	p a l o ʔ
paltaː	p a l t aː
palu	p a l u
palăk	p a l a k
pam̥õʊ̰ŋ	p a m o ʊ ŋ
pan	p a n
pãn	p a n
pana	p a n a
pand͡ʒ	p a n dʒ
papa	p a p a
papata	p a p a t a
par	p a ɾ
para	p a ɾ a
paru	p a ɾ u
parːu	p a ɾ u
pas	p a s
pasa	p a s a
pasai	p a s a i
patn	p a t n
patu̥	p a t u
paxtzaŋkʰ	p a f t z a ŋ kʰ
paʔ	p a ʔ
paɗa	p a d  a
paɾa	p a ɾ a
paʃatʰ	p a ʃ a tʰ
paădas	p a a d a s
paːe	p aː e
paːi	p aː i
paːlu	p aː l u
paːn	p aː n
paŋpaw	p a ŋ p a w
paːppʰodũ	p aː p pʰ o d u
paːr	p aː ɾ
paʔrasaŋaŋa	p a ʔ ɾ a s a ŋ a ŋ a
paʊs	p a ʊ s
paːt	p aː t
pa̤tn	p a t n
paɲu	p a ɲ u
paɾəɫ	p a ɾ ə ɫ
pe	p e
peçː	p e ç
pehme	p e h m e
pei	p e i
peku	p e k u
pentsamẽnd̪u	p e n t s a m e n d̪ u
pesɑɾ	p e s ɑ ɾ
peudaih	p e u d a i h
peunan	p e u n a n
peɪ	p e ɪ
peʔ	p e ʔ
peɾi	p e ɾ i
peːpeː	p eː p eː
pfe	p f e
pi	p i
pie	p i e
pika	p i k a
pinaŋa	p i n a ŋ a
pipa	p i p a
pir̥	p i ɾ
piti	p i t i
piɾ	p i ɾ
piʃ	p i ʃ
piɲa	p i ɲ a
piɛstɑ	p i ɛ s t ɑ
pja	p j a
pjo	p j o
pjɔs	p j ɔ s
pjɔ̰	p j ɔ
pks	p k s
pkʲæ	p k æ
plans	p l a n s
plãns	p l a n s
plɪukʃaet	p l ɪ u k ʃ a e t
plɛʒɔ	p l ɛ ʒ ɔ
po	p o
põ	p o
podi̥	p o d i
podzu	p o d z u
poho	p o h o
pokoʔ	p o k o ʔ
portun	p o ɾ t u n
poti̥	p o t i
potu	p o t u
poʊ	p o ʊ
poː	p oː
poːnʲɛ̞	p oː ɲ ɛ
pøːrɛ	p o ɾ ɛ
poɾtzankneɾ	p o ɾ t z a n k n e ɾ
poʊ̰	p o ʊ
põːŋ	p o ŋ
ppata	p p a t a
pqʰə	p kʰ ə
prɛsɛntɑ̞ɾ	p ɾ ɛ s ɛ n t ɑ ɾ
psa	p s a
ptaɾam	p t a ɾ a m
ptsaəia	p t s a ə i a
ptsiaəia	p t s i a ə i a
ptsə	p t s ə
ptsʼaʁuapɬ	p t s a f u a p ɫ
ptsʼaʃχua	p t s a ʃ f u a
ptsʼə	p t s ə
pt̪it̪sa	p t̪ i t̪ s a
pt͡ʃa	p tʃ a
pt͡ʃapsə	p tʃ a p s ə
pt͡ʃaʁa	p tʃ a f a
pueʔ	p u e ʔ
pujəɹ	p u j ə ɹ
pul	p u l
puldari	p u l d a ɾ i
pulu	p u l u
pulːo	p u l o
puola	p u o l a
pur̟ʌ	p u ɾ ə
pur̠ʌ	p u ɾ ə
putu̥	p u t u
put͡ʃvɑ	p u tʃ v ɑ
puː	p uː
puːc	p uː c
puʂpɑ	p u ʃ p ɑ
puʎu̥	p u ʎ u
puɹʌ	p u ɹ ə
pv̩	p v
pxa	p f a
pyː	p i
pɑ	p ɑ
pʰaipʰai	pʰ a i pʰ a i
pʰala	pʰ a l a
pʰaq̠ə	pʰ a k ə
pʲæsăaʒas	pʲ æ s a a ʒ a s
pʲæts	pʲ æ t s
pʲætuːs	pʲ æ t uː s
pʃatʰ	p ʃ a tʰ
pʰatʰ	pʰ a tʰ
pʰatɕʼa	pʰ a t ʃ a
pʰausɛ	pʰ a u s ɛ
pχauəʔʷ	p f a u ə ʔ
pʰæʔ	pʰ æ ʔ
pʼaʒ	p a ʒ
pʰaː	pʰ aː
pʲæ̆lʲs	pʲ æ l s
pʰãːma	pʰ aː m a
pʲæ̆nas	pʲ æ n a s
pʰaːŋ	pʰ aː ŋ
pʰa̰ʔ	pʰ a ʔ
pɑbɑhɑɯːɑn	p ɑ b ɑ h ɑ ʊ ɑ n
pədɑɾ	p ə d ɑ ɾ
pʰe	pʰ e
pʲeĕʃʲtsʲæs	pʲ e e ʃ t ʃ æ s
pɑid	p ɑ i d
pʰiko	pʰ i k o
pʰipʰ	pʰ i pʰ
pʰitsuu	pʰ i t s u u
pʲiːla	pʲ iː l a
pʁiːʔs	p f iː ʔ s
pɑk	p ɑ k
pɑkmɛr	p ɑ k m ɛ ɾ
pəkt	p ə k t
pălăk	p a l a k
pʰlɔnɔ	pʰ l ɔ n ɔ
pɔlʲtʲka	p ɔ l tʲ k a
pʰn	pʰ n
pɛntsamẽn̪d̪u	p ɛ n t s a m e n  d̪ u
pʼo	p o
pɾoi	p ɾ o i
pŏonas	p o o n a s
pŏopʲæɾʲs	p o o pʲ æ ɾʲ s
pŏopʲæʒʲs	p o o pʲ æ ʒ s
pʰotʰ	pʰ o tʰ
pʰoʁtʰãn	pʰ o f tʰ a n
pɑpʰi	p ɑ pʰ i
pɑq̠ɑɯ	p ɑ k ɑ ʊ
pɑrmɛk	p ɑ ɾ m ɛ k
pɑrolː	p ɑ ɾ o l
pɑrɑi	p ɑ ɾ ɑ i
pɑs	p ɑ s
pɔs	p ɔ s
pʌs	p ə s
pɑt	p ɑ t
pʉt	p ʉ t
p͡ta	p a
p͡tsa	p s a
pɛtu̥	p ɛ t u
p͡tʃi	p ʃ i
pʌtɪʔ	p ə t ɪ ʔ
pʰueʔ	pʰ u e ʔ
pʰul	pʰ u l
pʰur	pʰ u ɾ
pʰuto	pʰ u t o
pʰutʰ	pʰ u tʰ
pʰuək	pʰ u ə k
pĩŋ	p i ŋ
pɛə	p ɛ ə
pʃĩ	p ʃ i
pʰĩ	pʰ i
pʰʊ	pʰ ʊ
pɔɽa	p ɔ ɹ a
pɔɾa	p ɔ ɾ a
pəɽa	p ə ɹ a
pũːc	p uː c
pɯːhəðʲ	p ʊ h ə ð
pə̟i̯	p ə i
pɾẽm	p ɾ e m
pʰɔn	pʰ ɔ n
pɑːp	p ɑː p
pɑːpi	p ɑː p i
pɤːpm	p ʊ p m
pʰɑq̠ɑɪ	pʰ ɑ k ɑ ɪ
pɑːs	p ɑː s
pʰɪtsɛ̃	pʰ ɪ t s ɛ
pɔːtʲ	p ɔ tʲ
pɑːɾ	p ɑː ɾ
pʰəŋ	pʰ ə ŋ
pʰəʔ	pʰ ə ʔ
pʰɛŋ	pʰ ɛ ŋ
pʰɛɪ	pʰ ɛ ɪ
pʰɔː	pʰ ɔ
pʰʌʃi	pʰ ə ʃ i
pɛɲə̥	p ɛ ɲ ə
pɛ̝ʃə	p ɛ ʃ ə
pɔ̃ːŋ	p ɔ ŋ
pʰɔ̃ːŋ	pʰ ɔ ŋ
qa	k a
qawisqən	k a w i s k ə n
qilt	k i l t
qqar	k k a ɾ
qqim	k k i m
qʷa	kʷ a
q̠abak	k a b a k
q̠ae	k a e
q̠aidz	k a i d z
qʰakʷʼan	kʰ a kʷ a n
qʰal	kʰ a l
qʰantʰa	kʰ a n tʰ a
q̠an̪a	k a n  a
q̠anə̥	k a n ə
q̠arʃ	k a ɾ ʃ
q̠at	k a t
q̠au	k a u
q̠aɣ	k a ɡ
q̠aβa	k a v a
qʷaʕanaj	kʷ a ɹ a n a j
q̠aːd̪ãʊ	k aː d̪ a ʊ
q̠aːd̪d̪ʰava	k aː d̪ d a v a
q̠aːla	k aː l a
q̠aŋq̠	k a ŋ k
q̠ãŋə	k a ŋ ə
q̠aːʒɛ	k aː ʒ ɛ
q̠baa	k b a a
q̠bar	k b a ɾ
q̠bo	k b o
q̠bəɽa	k b ə ɹ a
q̠eo	k e o
qɑhar	k ɑ h a ɾ
qɑhhar	k ɑ h h a ɾ
q̠iador	k i a d o ɾ
q̠iak	k i a k
q̠ihæ	k i h æ
q̠ija	k i j a
q̠is̪ompɛtɾala	k i s o m p ɛ t ɾ a l a
q̠is̪on	k i s o n
q̠is̪on̪	k i s o n 
q̠iːɾu	k iː ɾ u
qɔlb	k ɔ l b
qɔlɒ	k ɔ l ɒ
q̠lɛpe	k l ɛ p e
q̠ma	k m a
q̠mɛ	k m ɛ
q̠noi	k n o i
q̠o	k o
q̠õ	k o
q̠od̪	k o d̪
q̠õd̪	k o d̪
q̠od͡ʒitɑɬ	k o dʒ i t ɑ ɫ
q̠ol	k o l
q̠ombaɾas̪io	k o m b a ɾ a s i o
q̠ouːl	k o uː l
q̠ovor̥	k o v o ɾ
q̠oɹ	k o ɹ
q̠øːq̠rɛ	k o k ɾ ɛ
q̠oʃt	k o ʃ t
q̠rad̪	k ɾ a d̪
q̠raːd̪	k ɾ aː d̪
q̠raʒs	k ɾ a ʒ s
q̠raːʒʲnʲtʲ	k ɾ aː ʒ ɲ tʲ
q̠rʏnːa	k ɾ u n a
q̠rɛq̠ɔs	k ɾ ɛ k ɔ s
q̠rʏːna	k ɾ uː n a
qʰud͡ʒar	kʰ u dʒ a ɾ
q̠ufːa	k u f  a
q̠uhaɾa	k u h a ɾ a
q̠uhema	k u h e m a
q̠uheːma	k u h eː m a
q̠ukʰaːβa	k u kʰ aː v a
q̠urɑ	k u ɾ ɑ
q̠usaːβa	k u s aː v a
q̠utça	k u t ç a
q̠utʰaβa	k u tʰ a v a
q̠ut͡ʃa	k u tʃ a
q̠uʃa	k u ʃ a
q̠uːðə	k uː ð ə
qʰuɾən	kʰ u ɾ ə n
q̠wa	k w a
q̠wɑɾ	k w ɑ ɾ
q̠yl	k i l
qɑɾ	k ɑ ɾ
qʰʷa	kʰ a
qʰʷaia	kʰ a i a
qʷʼajt͡ɬʼ	kʷ a j tʃ
qʰʷant͡ʃʼa	kʰ a n tʃ a
q̠ɔd	k ɔ d
q̠ĩjã	k i j a
q̠əla	k ə l a
qɒːlɒ	k ɒː l ɒ
q̠ɔm	k ɔ m
q̠əmaxneɾ	k ə m a f n e ɾ
q̠ɑmud	k ɑ m u d
qɒːmɒ	k ɒː m ɒ
q̠ɑmʌt	k ɑ m ə t
q̠ɑmʔud	k ɑ m ʔ u d
q̠ənuq̠nuʃka	k ə n u k n u ʃ k a
q̠ẽo	k e o
q̠ɦol	k h o l
q̠ʃq̠ʌ̃n	k ʃ k ə n
q̠ɛri	k ɛ ɾ i
q̠ərmi	k ə ɾ m i
q̠ərs	k ə ɾ s
q̠ɔsa	k ɔ s a
q̠ʏtl̥	k u t l
qʰətsa	kʰ ə t s a
q̠ɤz	k ʊ z
q̠ɔza	k ɔ z a
q̠ɑʃ	k ɑ ʃ
q̠ɔɹ	k ɔ ɹ
q̠əʔ	k ə ʔ
q̠ɤʃ	k ʊ ʃ
qʰʷə	kʰ ə
qɒʕɒd̪ɒ	k ɒ ɹ ɒ d̪ ɒ
qʰəɾeɪ	kʰ ə ɾ e ɪ
q̠əɾi	k ə ɾ i
q̠əɾʊ	k ə ɾ ʊ
ra	ɾ a
ræftæm	ɾ æ f t æ m
raha	ɾ a h a
ræhhʌb	ɾ æ h h ə b
rai	ɾ a i
rak	ɾ a k
rap	ɾ a p
rapiʔ	ɾ a p i ʔ
ras	ɾ a s
rat̪	ɾ a t̪
ræt̪t̪əb	ɾ æ t̪ t̪ ə b
ræt̪ɪb	ɾ æ t̪ ɪ b
raut̪	ɾ a u t̪
rauː	ɾ a uː
ravintolaːn	ɾ a v i n t o l aː n
rawa	ɾ a w a
raz	ɾ a z
razm̩	ɾ a z m
raħ	ɾ a h
raʕ	ɾ a ɹ
raʔah	ɾ a ʔ a h
raːm	ɾ aː m
ræχs	ɾ æ f s
raːsi	ɾ aː s i
raʒulon	ɾ a ʒ u l o n
ræʃʃ	ɾ æ ʃ ʃ
ræʒʒ	ɾ æ ʒ ʒ
raŋɡa	ɾ a ŋ ɡ a
raħəb	ɾ a h ə b
rba	ɾ b a
rdɔə	ɾ d ɔ ə
rebːiəħ	ɾ e b i ə h
rei	ɾ e i
repħ	ɾ e p h
req̠lə	ɾ e k l ə
reːn	ɾ eː n
reːv	ɾ eː v
rha	ɾ h a
rhü	ɾ h u
ri	ɾ i
rimaː	ɾ i m aː
rimːaː	ɾ i m aː
rinni	ɾ i n n i
rio	ɾ i o
riuriu	ɾ i u ɾ i u
rob	ɾ o b
roi	ɾ o i
rokʰʲn̥	ɾ o kʰ n
romokʰ	ɾ o m o kʰ
romːɛl	ɾ o m ɛ l
rosŋq̠i	ɾ o s ŋ k i
roːk	ɾ oː k
røːtʰ	ɾ o tʰ
rris	ɾ ɾ i s
rü	ɾ u
rui	ɾ u i
ruoko	ɾ u o k o
ruːan	ɾ uː a n
ruħas	ɾ u h a s
r̥at̪o	ɾ a t̪ o
r̥auː	ɾ a uː
rʲæŋʲɡʲmas	ɾʲ æ ŋ ɡ m a s
rɑbɛr	ɾ ɑ b ɛ ɾ
r̥iŋ̥t	ɾ i ŋ t
rɑkj	ɾ ɑ k j
rɑkʰ	ɾ ɑ kʰ
rɑman	ɾ ɑ m a n
rɑmun	ɾ ɑ m u n
rɑmɑn	ɾ ɑ m ɑ n
rĩn	ɾ i n
rɑpis	ɾ ɑ p i s
rɑpɑs	ɾ ɑ p ɑ s
rɪq̠na	ɾ ɪ k n a
rɑrɑy	ɾ ɑ ɾ ɑ i
rɑsi	ɾ ɑ s i
rɑsɑ	ɾ ɑ s ɑ
rɑsɑm	ɾ ɑ s ɑ m
rʊtɪb	ɾ ʊ t ɪ b
r̥uːpʌ	ɾ uː p ə
rɯː	ɾ ʊ
rə̟i̯s	ɾ ə i s
rɔːk	ɾ ɔ k
rɛːsi	ɾ ɛ s i
rəʔuːs	ɾ ə ʔ uː s
r̥əvi	ɾ ə v i
rɑʕʊb	ɾ ɑ ɹ ʊ b
rˠɛ̃ːv	ɾ ɛː v
s	s
sa	s a
sã	s a
sãã	s a a
sabo	s a b o
saboh	s a b o h
sæbəb	s æ b ə b
sacqʷaʕʷʕʷ	s a c kʷ a ɹ ɹ
sæfa	s æ f a
safar	s a f a ɾ
sæhɞr	s æ h ə ɾ
sai	s a i
sak	s a k
saka	s a k a
saks	s a k s
saku̥	s a k u
sækən	s æ k ə n
saloq̠	s a l o k
sampoh	s a m p o h
sand͡ʒek	s a n dʒ e k
sanwits	s a n w i t s
san̪t̪e	s a n  t̪ e
sapa	s a p a
saq̠lo	s a k l o
sara	s a ɾ a
saraa	s a ɾ a a
sarir	s a ɾ i ɾ
sar̥	s a ɾ
sær̥	s æ ɾ
sas	s a s
saseo	s a s e o
saseu	s a s e u
sætl̥	s æ t l
sattʰẽ	s a t tʰ e
satẽ	s a t e
saup	s a u p
saut̪	s a u t̪
sauː	s a uː
sæva	s æ v a
saɡ	s a ɡ
saɾ	s a ɾ
saʔ	s a ʔ
saː	s aː
saʔa	s a ʔ a
sãɡaa	s a ɡ a a
saːd͡ʒana	s aː dʒ a n a
saːd͡ʒanu	s aː dʒ a n u
saŋd͡ʒe	s a ŋ dʒ e
sæʔimə	s æ ʔ i m ə
sæʔiːm	s æ ʔ iː m
saɪjɛr	s a ɪ j ɛ ɾ
saːlu	s aː l u
saːm	s aː m
sãːmõ	s aː m o
saːr	s aː ɾ
sæʔələ	s æ ʔ ə l ə
saʊɽo	s a ʊ ɹ o
sæːʔələ	s æ ʔ ə l ə
sa̰ɪ̰ʔjwɛ	s a ɪ ʔ j w ɛ
sbʲɾʲææ̆sʲtʲ	s bʲ ɾʲ æ æ ʃ tʲ
scam	s c a m
scxaʕpmix	s c f a ɹ p m i f
se	s e
sel	s e l
sema	s e m a
seni	s e n i
seq̠aŋ	s e k a ŋ
serir	s e ɾ i ɾ
ser̥	s e ɾ
setl	s e t l
seʔku	s e ʔ k u
seːlo	s eː l o
seʔrea	s e ʔ ɾ e a
seːr̥	s eː ɾ
seɪŋ	s e ɪ ŋ
shahimaʔ	s h a h i m a ʔ
shahənk	s h a h ə n k
si	s i
siau	s i a u
sibɪt	s i b ɪ t
sid͡ʒə	s i dʒ ə
siha	s i h a
sika	s i k a
sikali	s i k a l i
sikaŋkaŋ	s i k a ŋ k a ŋ
siklaʊd	s i k l a ʊ d
sikɑ	s i k ɑ
sila	s i l a
sili	s i l i
sim	s i m
sinĩ	s i n i
sio	s i o
siopɔ	s i o p ɔ
siper	s i p e ɾ
siq̠arilyo	s i k a ɾ i l i o
siq̠aŋq̠aŋ	s i k a ŋ k a ŋ
sirɑ	s i ɾ ɑ
sir̥	s i ɾ
siu	s i u
siɲa	s i ɲ a
siːla	s iː l a
sjazi	s j a z i
sk	s k
skæʁbə	s k æ f b ə
skoɾ	s k o ɾ
skoʔ	s k o ʔ
skuə̯ɾ	s k u ə ɾ
skyr	s k i ɾ
skyʔ	s k i ʔ
skəmasqt	s k ə m a s k t
skəɾf	s k ə ɾ f
skɛ̞ɾ	s k ɛ ɾ
skɛ̞ɾf	s k ɛ ɾ f
skɑːɾə	s k ɑː ɾ ə
sla	s l a
slanaaw̃a	s l a n a a w a
slanaw̃a	s l a n a w a
slʲtʲiːs	s l tʲ iː s
smejʊ	s m e j ʊ
snavəɫ	s n a v ə ɫ
sni	s n i
sob̤ɦa	s o b h a
sodumk	s o d u m k
sofɔs	s o f ɔ s
solɑ	s o l ɑ
søn	s o n
sor̥	s o ɾ
sorŋq̠i	s o ɾ ŋ k i
sot̪	s o t̪
souxos	s o u f o s
soŋ	s o ŋ
søː	s o
soɞa	s o ə a
soːddʰuk	s oː d d u k
soːk	s oː k
soɽo	s o ɹ o
soɞwa	s o ə w a
so̰ʔ	s o ʔ
stãvs	s t a v s
stiyaʔ	s t i i a ʔ
stkkicaʔ	s t k k i c a ʔ
støulə	s t o u l ə
stqsumən	s t k s u m ə n
st̪ut̪i	s t̪ u t̪ i
st͡ʃu	s tʃ u
su	s u
sui	s u i
sulit	s u l i t
sumbuŋ	s u m b u ŋ
sunsun	s u n s u n
suo	s u o
suoda	s u o d a
suomi	s u o m i
suri	s u ɾ i
sus	s u s
suwəs	s u w ə s
suðor	s u ð o ɾ
suːs	s uː s
sverʊ	s v e ɾ ʊ
sveːt̪	s v eː t̪
svɛrʊ	s v ɛ ɾ ʊ
swa	s w a
swan	s w a n
syaʔk	s i a ʔ k
syn	s i n
syød	s i o d
syr	s i ɾ
syu	s i u
syʔ	s i ʔ
sŋ	s ŋ
sʔ	s ʔ
sʲænkʲe	ʃ æ n k e
sɛbbəb	s ɛ b b ə b
sɑbɑt	s ɑ b ɑ t
săb̤ɦa	s a b h a
sɑf	s ɑ f
sɔhoa	s ɔ h o a
sɔhɑ	s ɔ h ɑ
sʼikʷʰan	s i kʷ a n
sʼiqʷʼa	s i kʷ a
sɛku̥	s ɛ k u
sɔkɑ	s ɔ k ɑ
sɛkɑ	s ɛ k ɑ
sɑl	s ɑ l
sɑldɑ	s ɑ l d ɑ
sɑli	s ɑ l i
sɛljoɯ	s ɛ l j o ʊ
sɑltʰɑ	s ɑ l tʰ ɑ
sɑlɪb	s ɑ l ɪ b
sʊlɪb	s ʊ l ɪ b
sɑlɯq̠	s ɑ l ʊ k
sɛlːɛp	s ɛ l ɛ p
səm	s ə m
sən	s ə n
sɔp	s ɔ p
səp	s ə p
sɑq	s ɑ k
sʌq̠	s ə k
sɑq̠ə	s ɑ k ə
sɑq̠ɑd	s ɑ k ɑ d
sɑq̠ɑt	s ɑ k ɑ t
sɑri	s ɑ ɾ i
sʊriɑ	s ʊ ɾ i ɑ
sɑrmiŋ	s ɑ ɾ m i ŋ
sɨrr	s ɪ ɾ ɾ
sɑrtin	s ɑ ɾ t i n
săs	s a s
sʲsʲtʲ	ʃ ʃ tʲ
sɞt	s ə t
sʌtor	s ə t o ɾ
sʌttari	s ə t t a ɾ i
sɑt͡ʃ	s ɑ tʃ
sɛt͡ʃmax	s ɛ tʃ m a f
sɑt͡ʃmɑx	s ɑ tʃ m ɑ f
s̪u	s u
sĩĩ	s i i
sũũ	s u u
sɑɾ	s ɑ ɾ
sɔʔ	s ɔ ʔ
səŋ	s ə ŋ
sɾʔ	s ɾ ʔ
sɔː	s ɔ
sʰḭ	ʃ i
sʕʷaʔʕʷaʔ	s ɹ a ʔ ɹ a ʔ
sɑːbɑd	s ɑː b ɑ d
sʼũj̃	s u j
sɔːk	s ɔ k
sɑŋka	s ɑ ŋ k a
sɑʃmɑx	s ɑ ʃ m ɑ f
sẽĩn	s e i n
sɛɸoɸo	s ɛ ɸ o ɸ o
sɪəpsɪəb	s ɪ ə p s ɪ ə b
sɑŋq̠ɑ	s ɑ ŋ k ɑ
sʲɛte	ʃ ɛ t e
sʲŭusʲtʲ	ʃ u u ʃ tʲ
sɪ̰ʔ	s ɪ ʔ
sʰɪŋ	ʃ ɪ ŋ
sɔħɒlɒ	s ɔ h ɒ l ɒ
sɪ̃ŋsa	s ɪ ŋ s a
sɑʔɑt	s ɑ ʔ ɑ t
sʰɪ̃ŋ	ʃ ɪ ŋ
t	t
ta	t a
tã	t a
taa	t a a
taato	t a a t o
tabakoʔ	t a b a k o ʔ
tabalu	t a b a l u
tah	t a h
tahiː	t a h iː
tai	t a i
taipa	t a i p a
taipaija	t a i p a i j a
tæko	t æ k o
takot	t a k o t
takɫ̩	t a k ɫ̩
tal	t a l
tallua	t a l l u a
taloa	t a l o a
talon	t a l o n
talonvki	t a l o n v k i
taloːn	t a l oː n
talɔn	t a l ɔ n
tæmam	t æ m a m
tamar	t a m a ɾ
tamonq̠	t a m o n k
tæmum	t æ m u m
tan	t a n
tãn	t a n
tap	t a p
taq̠doʔ	t a k d o ʔ
taq̠oʃ	t a k o ʃ
tar	t a ɾ
tærkeæ	t æ ɾ k e æ
tata	t a t a
tat͡saq̠a	t a tʃ a k a
tau	t a u
tæv	t æ v
tawa	t a w a
taʔ	t a ʔ
taː	t aː
ta̤h	t a h
ta̤i	t a i
taʒikɑ̃nɛ̃	t a ʒ i k ɑ n ɛ
tæ̃ko	t æ k o
taŋkʰ	t a ŋ kʰ
taːla	t aː l a
taːm	t aː m
taːn	t aː n
taɪr	t a ɪ ɾ
taɪt̪	t a ɪ t̪
tãːv	t aː v
taːŋ	t aː ŋ
tæ̃ːvs	t æ v s
tbaɪjo	t b a ɪ j o
td̪iɬhɪɬi	t d̪ i ɫ h ɪ ɫ i
te	t e
tee	t e e
teia	t e i a
texnɪkə	t e f n ɪ k ə
teyʔcua	t e i ʔ c u a
teyʔtibdup	t e i ʔ t i b d u p
teyʔya̠da̠ʔ	t e i ʔ i a d a ʔ
teːʔ	t eː ʔ
te̝ŋq̠ə	t e ŋ k ə
teːɲɲu	t eː ɲ ɲ u
teːŋŋʌ	t eː ŋ ŋ ə
ti	t i
tiera	t i e ɾ a
tili	t i l i
tindro	t i n d ɾ o
tini	t i n i
tinidor	t i n i d o ɾ
tinq̠ia	t i n k i a
tippe	t i p p e
tit	t i t
tiutɔs	t i u t ɔ s
ti̠	t i
tiːa	t iː a
tiːh	t iː h
tiŋin	t i ŋ i n
tiːli	t iː l i
tiɔn	t i ɔ n
tiːn	t iː n
tiːni	t iː n i
ti̤ː	t i
ti̤ːa	t i a
tiə̯l	t i ə l
tiːɯn	t iː ʊ n
tjawo	t j a w o
tjaːq̠a	t j aː k a
tjɛnɛ	t j ɛ n ɛ
tlokɑ	t l o k ɑ
tlɛʃ	t l ɛ ʃ
to	t o
tõ	t o
toa	t o a
toana	t o a n a
toç	t o ç
tøit	t o i t
tojen̠d̠ʑaanodˀaa	t o j e n d ʒ a a n o d a a
tojːɔm	t o j ɔ m
tok	t o k
tolɔtʰ	t o l ɔ tʰ
tolːɔtʰ	t o l ɔ tʰ
topaadˀaa	t o p a a d a a
towow	t o w o w
toɾ	t o ɾ
toʔ	t o ʔ
toː	t oː
to̤h	t o h
toŏks	t o o k s
toχm	t o f m
to̠o̠	t o o
tøːrɛ	t o ɾ ɛ
toːtn	t oː t n
to̤ːtn	t oː t n
triːpədi	t ɾ iː p ə d i
ts	t s
tsa	t s a
tsä	t s a
tsap	t s a p
tseɣ	t s e ɡ
tseɾ	t s e ɾ
tsi	t s i
tsiau	t s i a u
tsiaŋ	t s i a ŋ
tsiʔ	t s i ʔ
tsiːja	t s iː j a
tskɾs	t s k ɾ s
tsokː	t s o k
tsuiaŋ	t s u i a ŋ
tsĩ	t s i
tsə	t s ə
tsɛ	t s ɛ
tsɪ	t s ɪ
tsʼ	t s
tsʰa	t ʃ a
tsʼa	t s a
tsɪamə	t s ɪ a m ə
tsɪanə	t s ɪ a n ə
tsɪaɲə	t s ɪ a ɲ ə
tsʰia	t ʃ i a
tsʲiipʲtʲ	t ʃ i i pʲ tʲ
tsʊnno	t s ʊ n n o
tsɛn̥t͡ʃo	t s ɛ n tʃ o
tsĩnɑɛɬi	t s i n ɑ ɛ ɫ i
tsʰo	t ʃ o
tsɪt	t s ɪ t
tsɛtsɛ	t s ɛ t s ɛ
tsʰuŋ	t ʃ u ŋ
tsəza	t s ə z a
tsɑɬ	t s ɑ ɫ
tsəħa	t s ə h a
tsʼəfə	t s ə f ə
tsʼəkʷʼ	t s ə kʷ
tsʰɪt	t ʃ ɪ t
tsəʁua	t s ə f u a
tsɛʎʊ	t s ɛ ʎ ʊ
ttaʕumaʔ	t t a ɹ u m a ʔ
ttəd̠	t t ə d
tu	t u
tualɛta	t u a l ɛ t a
tuhto	t u h t o
tulay	t u l a i
tule	t u l e
tuli	t u l i
tulːe	t u l e
tulːeː	t u l eː
tulːi	t u l i
tunuq̠	t u n u k
tuo	t u o
tuotuo	t u o t u o
tutu	t u t u
tutɔs	t u t ɔ s
tuunɔ	t u u n ɔ
tuwa	t u w a
tuʔ	t u ʔ
tuːakŋ	t uː a k ŋ
tuːaʔ	t uː a ʔ
tuːk	t uː k
tuːle	t uː l e
tuːli	t uː l i
tuːlːe	t uː l e
tuːlːeː	t uː l eː
tuʔoɯ	t u ʔ o ʊ
tuːtn	t uː t n
tuətɕan	t u ə t ʃ a n
tuə̯ɾ	t u ə ɾ
tv̩	t v
twende	t w e n d e
twiːl̪	t w iː l
twɛn	t w ɛ n
twɪ̰	t w ɪ
tyøt	t i o t
tĩ	t i
tœ	t o
tũ	t u
tɔ	t ɔ
tɕ	t ʃ
tɛ	t ɛ
tɨ	t ɪ
tʊ	t ʊ
t̪abʌχ	t̪ a b ə f
tɕafə	t ʃ a f ə
tʰai	tʰ a i
tʰak	tʰ a k
tʰakku	tʰ a k k u
tʼakʷʼ	t a kʷ
tʰala	tʰ a l a
tɕamə	t ʃ a m ə
t̠aməttutt	t a m ə t t u t t
t̪an̪	t̪ a n 
tɕapm	t ʃ a p m
tʰær̥	tʰ æ ɾ
tʲæse	tʲ æ s e
tɕat	t ʃ a t
tʼatsɑ	t a t s ɑ
tɕatsʼə	t ʃ a t s ə
tɕatə	t ʃ a t ə
tɕatəw	t ʃ a t ə w
tʰaĩ	tʰ a i
t̪aː	t̪ aː
tʰaːki	tʰ aː k i
tʰaːm	tʰ aː m
tʰaːp	tʰ aː p
tʲæːsʲnʲĭis	tʲ æ ʃ ɲ i i s
t̪aːt	t̪ aː t
tɕaɕə	t ʃ a ʃ ə
tʰæ̃ŋ	tʰ æ ŋ
tʰaːʃi	tʰ aː ʃ i
tʰaːɽʌ	tʰ aː ɹ ə
tɑbɒ	t ɑ b ɒ
tɔbɛ	t ɔ b ɛ
təbɛ̰	t ə b ɛ
tʰe	tʰ e
t̪eilatu	t̪ e i l a t u
tɛh	t ɛ h
tṳh	t u h
tɨhey	t ɪ h e i
tɨheʔ	t ɪ h e ʔ
tɕi	t ʃ i
t̠itt	t i t t
tɕi̠	t ʃ i
t̪iːn	t̪ iː n
tʲiːʒɛ	tʲ iː ʒ ɛ
tɑk	t ɑ k
tʲk	tʲ k
tʲkrăi	tʲ k ɾ a i
tɛkə	t ɛ k ə
təkʷp	t ə kʷ p
tɪkʲə	t ɪ k ə
tɑl	t ɑ l
tɔlb	t ɔ l b
tʰm	tʰ m
t̪mɑx	t̪ m ɑ f
tɔn	t ɔ n
tʰn	tʰ n
tɛnde	t ɛ n d e
tʲnkama	tʲ n k a m a
tʲnkamas	tʲ n k a m a s
tʰnot	tʰ n o t
tɛntə	t ɛ n t ə
tɑo	t ɑ o
tʒokʰ	t ʒ o kʰ
tʒõkʰ	t ʒ o kʰ
tʰõm	tʰ o m
t̪or	t̪ o ɾ
tʰou	tʰ o u
tʲoːnəx	tʲ oː n ə f
tɑp	t ɑ p
təpaːlu	t ə p aː l u
tɑpkilː	t ɑ p k i l
tɑq̠ɑ	t ɑ k ɑ
tɑq̠ɑm	t ɑ k ɑ m
t̪reba	t̪ ɾ e b a
tɔrtas	t ɔ ɾ t a s
tɔs	t ɔ s
t͡s	tʃ
t̪sar	t̪ s a ɾ
t͡sdakʰa	tʃ d a kʰ a
t͡sʰ	tʃ
t͡sʼai	tʃ a i
t͡sʼat͡sʼa	tʃ a tʃ a
t͡sʼãːmõ	tʃ aː m o
tɛsɛ̃	t ɛ s ɛ
tɾtas	t ɾ t a s
tɑtə	t ɑ t ə
tɛtɛtʰ	t ɛ t ɛ tʰ
tʰuin	tʰ u i n
t̪ullo	t̪ u l l o
t̪ulo	t̪ u l o
tʰur	tʰ u ɾ
tŭurs	t u u ɾ s
tʰuwaq̠	tʰ u w a k
tʲuːriʃ	tʲ uː ɾ i ʃ
t̪voj	t̪ v o j
t̪vrd	t̪ v ɾ d
tʰweɪ	tʰ w e ɪ
tɑɾ	t ɑ ɾ
tɑχ	t ɑ f
tɔŋ	t ɔ ŋ
tɔʔ	t ɔ ʔ
tɕə	t ʃ ə
təŋ	t ə ŋ
təʔ	t ə ʔ
tɔː	t ɔ
tɔ̃	t ɔ
tɕʼ	t ʃ
tɛ̃	t ɛ
tɾʲ	t ɾʲ
tʰɔ	tʰ ɔ
tʰɲ	tʰ ɲ
t̪ʰ	tʰ
t͡ʃ	tʃ
təɽa	t ə ɹ a
tṳːa	t uː a
t͡ʃa	tʃ a
tũːal	t uː a l
t̠ɕamũ	t ʃ a m u
t͡ʃan	tʃ a n
t͡ʃap	tʃ a p
tɕʼasa	t ʃ a s a
t͡ʃasː	tʃ a s
t͡ʃat͡ʃa	tʃ a tʃ a
t͡ʃaɯ	tʃ a ʊ
tɕʼaɮa	t ʃ a ɫ a
t͡ʃaːm	tʃ aː m
t͡ʃaːp	tʃ aː p
t͡ʃaːr	tʃ aː ɾ
təθaʊŋ	t ə θ a ʊ ŋ
t͡ʃaʊʔ	tʃ a ʊ ʔ
t͡ʃaːŋ	tʃ aː ŋ
t͡ʃaʒʲiːtʲ	tʃ a ʒ iː tʲ
t͡ʃæŋɢʲ	tʃ æ ŋ ɡ
t͡ʃedo	tʃ e d o
t͡ʃedu	tʃ e d u
t͡ʃekt͡ʃek	tʃ e k tʃ e k
t͡ʃekt͡ʃiːk	tʃ e k tʃ iː k
t̪ʃemer	t̪ ʃ e m e ɾ
t͡ʃerm	tʃ e ɾ m
t͡ʃesm	tʃ e s m
tʲĕetʲs	tʲ e e tʲ s
t͡ʃeʃm̥	tʃ e ʃ m
t͡ʃhaɭ	tʃ h a ɫ
tɕʰi	t ʃ i
t͡ʃi	tʃ i
t͡ʃian	tʃ i a n
t͡ʃih	tʃ i h
t͡ʃikʰi	tʃ i kʰ i
t͡ʃip	tʃ i p
t͡ʃiq̠i	tʃ i k i
t͡ʃit	tʃ i t
tʰɔivan	tʰ ɔ i v a n
tɔ̃iʃ	t ɔ i ʃ
tə̟i̯	t ə i
t͡ʃiːk	tʃ iː k
t͡ʃiːɾu	tʃ iː ɾ u
tʰɛk	tʰ ɛ k
tɑːkɑm	t ɑː k ɑ m
tɨ̠kɨt	t ɪ k ɪ t
tɑːl	t ɑː l
tɛ̞l	t ɛ l
tṳːl	t uː l
tɑːlum	t ɑː l u m
tʲɛlɔ	tʲ ɛ l ɔ
tɾɛlɔs	t ɾ ɛ l ɔ s
t̪əmællæk	t̪ ə m æ l l æ k
t̪əmallʌʔ	t̪ ə m a l l ə ʔ
tɕən	t ʃ ə n
tʰən	tʰ ə n
tʰənaem	tʰ ə n a e m
t͡ʃõ	tʃ o
t͡ʃomet	tʃ o m e t
t͡ʃøməʁ	tʃ o m ə f
t͡ʃøn	tʃ o n
t͡ʃoː	tʃ oː
tɯ̤p	t ʊ p
t͡ʃp	tʃ p
tʰətʰu	tʰ ə tʰ u
tɾʲtʲɛ̞	t ɾʲ tʲ ɛ
t̠ɕu	t ʃ u
tʰɛuna	tʰ ɛ u n a
t͡ʃunq̠u	tʃ u n k u
t͡ʃuək	tʃ u ə k
tɕəɮ	t ʃ ə ɫ
tɪ̰ʔ	t ɪ ʔ
tʊːɳ	t ʊ ɲ 
tʊ̃ŋ	t ʊ ŋ
tʊ̰̃	t ʊ
tʰəŋ	tʰ ə ŋ
tʰəʔ	tʰ ə ʔ
t̪ɑɹ	t̪ ɑ ɹ
t̪ʰɑ	tʰ ɑ
t͡ʃɔ	tʃ ɔ
t͡ʃɛ	tʃ ɛ
t͡ʃʼ	tʃ
tʊ̃ʒã	t ʊ ʒ a
t͡ʃʰa	tʃ a
t͡ʃʼa	tʃ a
t͡ʃʲædʲiːtʲ	tʃ æ dʲ iː tʲ
t͡ʃʰaːk	tʃ aː k
t͡ʃʰaʊ̰ʔ	tʃ a ʊ ʔ
t͡ʃəbɑ̃ŋ	tʃ ə b ɑ ŋ
t͡ʃɑi	tʃ ɑ i
t͡ʃʰi	tʃ i
t͡ʃəian	tʃ ə i a n
t͡ʃʰindati	tʃ i n d a t i
t͡ʃʰit	tʃ i t
t͡ʃʰiu	tʃ i u
t͡ʃʰiː	tʃ iː
t͡ʃʌj	tʃ ə j
t͡ʃɛmpɛ	tʃ ɛ m p ɛ
tɯɨːn	t ʊ ɪ n
t͡ʃən	tʃ ə n
t͡ʃɪnĩ	tʃ ɪ n i
t͡ʃũn̪	tʃ u n 
t̪ʰʌn̪d̪i	tʰ ə n  d̪ i
t͡ʃɑp	tʃ ɑ p
t͡ʃɛrɔɔ	tʃ ɛ ɾ ɔ ɔ
t͡ʃɛst	tʃ ɛ s t
t͡ʃœt	tʃ o t
t͡ʃət	tʃ ə t
t͡ʃɪtːʃa	tʃ ɪ t ʃ a
t͡ʃɪt͡ʃɪl	tʃ ɪ tʃ ɪ l
t̪ʲɪuja	c ɪ u j a
tɯːɲə	t ʊ ɲ ə
tɔ̃ɔ̃	t ɔ ɔ
tʰɔːŋ	tʰ ɔ ŋ
tʰɔ̃ŋ	tʰ ɔ ŋ
t͡ʃɨə	tʃ ɪ ə
t͡ʃɯə	tʃ ʊ ə
t͡ʃɔː	tʃ ɔ
t͡ʃʰŋ	tʃ ŋ
t͡ʃəʔa	tʃ ə ʔ a
t͡ʃʼəbʑ	tʃ ə b ʒ
tʼɑ̃ʒi	t ɑ ʒ i
t͡ʃɔ̃kɔ	tʃ ɔ k ɔ
t͡ʃʰən	tʃ ə n
təɦʌʉs	t ə h ə ʉ s
t͡ʃɑʔs	tʃ ɑ ʔ s
t͡ʃʰĩt	tʃ i t
t̪ɪɛ̃t̪ɪ	t̪ ɪ ɛ t̪ ɪ
t͡ʃʰʌt̪ɾi	tʃ ə t̪ ɾ i
tʰẽɪ̃ŋ	tʰ e ɪ ŋ
t͡ʃəɣə	tʃ ə ɡ ə
t͡ʃœːŋ	tʃ oː ŋ
t͡ʃʰɔː	tʃ ɔ
tɔ̃ːʃəxan	t ɔ ʃ ə f a n
tʲʰɛ̃ɣə	tʰ ɛ ɡ ə
t͡ʃʰœːŋ	tʃ oː ŋ
u	u
ua	u a
uaʔ	u a ʔ
ubuq̠	u b u k
ubɛ	u b ɛ
ud͡ʒo	u dʒ o
ue	u e
uhɛ̃	u h ɛ
ui	u i
üj	u j
ujː	u j
uku	u k u
ukuwa	u k u w a
ukwu	u k w u
ukʰuq̠uɾukwaːnd͡ʒe	u kʰ u k u ɾ u k w aː n dʒ e
ukʰuβokʰokwaːnd͡ʒe	u kʰ u v o kʰ o k w aː n dʒ e
ül	u l
ulos	u l o s
umala	u m a l a
umbʰ	u m b
umntu	u m n t u
umti	u m t i
umufa	u m u f a
umulilo	u m u l i l o
umulilonauʃimakale	u m u l i l o n a u ʃ i m a k a l e
umuti	u m u t i
umutsaːma	u m u t s aː m a
una	u n a
unæ	u n æ
un̪	u n 
uo	u o
upɑɪ	u p ɑ ɪ
upʌɖɔ	u p ə ɖ ɔ
uq̠li	u k l i
uq̠ɔr	u k ɔ ɾ
ur	u ɾ
üräf	u ɾ a f
urdɛn	u ɾ d ɛ n
urot	u ɾ o t
uruk	u ɾ u k
urwa	u ɾ w a
üs	u s
usuwoq̠	u s u w o k
utaŋ	u t a ŋ
utib	u t i b
utihi	u t i h i
utim	u t i m
utin	u t i n
uton	u t o n
utʰæbør	u tʰ æ b o ɾ
utʰo	u tʰ o
uva	u v a
uwa	u w a
uwafuvje	u w a f u v j e
uwoː	u w oː
uwɒʕɒd̪ɒ	u w ɒ ɹ ɒ d̪ ɒ
uxe	u f e
uy	u i
uzar	u z a ɾ
uβa	u v a
uħas	u h a s
uɡbo	u ɡ b o
uːbɑɪ	uː b ɑ ɪ
uːj	uː j
uənatɕʼa	u ə n a t ʃ a
uːr	uː ɾ
uətsə	u ə t s ə
uɾukʰoβaɾq̠waːnd͡ʒe	u ɾ u kʰ o v a ɾ k w aː n dʒ e
uβuɾaja	u v u ɾ a j a
uʔwa	u ʔ w a
uɔʔ	u ɔ ʔ
uəʔ	u ə ʔ
uɛʔ	u ɛ ʔ
uɛ̃	u ɛ
uə̃n	u ə n
uɾɞqɞm	u ɾ ə k ə m
uŭʃt	u u ʃ t
uːʒʲu	uː ʒ u
uə̯ɾə	u ə ɾ ə
va	v a
vabʒʲd͡ʒʲŭu	v a b ʒ dʒ u u
væd	v æ d
vailana	v a i l a n a
vaitn̥a	v a i t n a
vaiʔ	v a i ʔ
vaiːna	v a iː n a
vajassu	v a j a s s u
vala	v a l a
vãləxk	v a l ə f k
van̥ta	v a n t a
var	v a ɾ
varsa	v a ɾ s a
varta	v a ɾ t a
vas	v a s
vasəm	v a s ə m
vat̪ʰ	v a tʰ
vauː	v a uː
vaza	v a z a
vazo	v a z o
vaɾa	v a ɾ a
vaɾja	v a ɾ j a
vaːla	v aː l a
vaːnɪ	v aː n ɪ
væχt	v æ f t
vaɾtskʰ	v a ɾ t s kʰ
vaːt͡ʃɛk	v aː tʃ ɛ k
vaːva	v aː v a
vaːvi	v aː v i
vaɾvɑʃʲə	v a ɾ v ɑ ʃ ə
vaːza	v aː z a
væʃʲtʲ	v æ ʃ tʲ
vehɹ	v e h ɹ
ves	v e s
veɹ	v e ɹ
veːɹɳ	v eː ɹ ɲ 
vi	v i
viazo	v i a z o
vilːe	v i l e
vitsː	v i t s
viːla	v iː l a
viʃə	v i ʃ ə
viːə	v iː ə
viʃʌja	v i ʃ ə j a
vla	v l a
vod͡ʒa	v o dʒ a
vosumk	v o s u m k
vøː	v o
voːnʲja	v oː ɲ j a
voːɖza	v oː ɖ z a
vrʌk	v ɾ ə k
vuizo	v u i z o
vuo	v u o
vuɛɾɔs	v u ɛ ɾ ɔ s
vvu	v v u
vɾan	v ɾ a n
vɪanaːdɪ	v ɪ a n aː d ɪ
vɔas	v ɔ a s
vəklə	v ə k l ə
vɔl	v ɔ l
vĩliʃ	v i l i ʃ
vũləx	v u l ə f
vɔr	v ɔ ɾ
vɔs	v ɔ s
vɛs	v ɛ s
vɑssuːka	v ɑ s s uː k a
vɛsː	v ɛ s
vɛtʰ	v ɛ tʰ
vɛtʰː	v ɛ tʰ
vʲzʲtas	vʲ z t a s
vɑʃ	v ɑ ʃ
vɔʃ	v ɔ ʃ
vəʔ	v ə ʔ
vɛ̃	v ɛ
və̟i̯	v ə i
vɑːi̯ŋki	v ɑː i ŋ k i
vɔːk	v ɔ k
vɔ̃ləx	v ɔ l ə f
vɛːra	v ɛ ɾ a
vɛʃɛ	v ɛ ʃ ɛ
vɛʃːɛ	v ɛ ʃ ɛ
wa	w a
wæbør	w æ b o ɾ
wahala	w a h a l a
waija	w a i j a
wailua	w a i l u a
waiŋwai	w a i ŋ w a i
wala	w a l a
wama	w a m a
wana	w a n a
wappa	w a p p a
warəd	w a ɾ ə d
waski	w a s k i
wawdaʔ	w a w d a ʔ
wawyuk	w a w i u k
waɾa	w a ɾ a
waːqafə	w aː k a f ə
waːsaʕ	w aː s a ɹ
waːwa	w aː w a
waːɡa	w aː ɡ a
wende	w e n d e
wents	w e n t s
whe	w h e
witⁿ	w i t  
wiwo	w i w o
wiːwiː	w iː w iː
wn	w n
wo	w o
woɾɞb	w o ɾ ə b
wsə	w s ə
wsɑm	w s ɑ m
wwawəlx	w w a w ə l f
wə	w ə
wɛ	w ɛ
w̃a	w a
w̝arw̝ar	w a ɾ w a ɾ
wɛduat	w ɛ d u a t
wɨk	w ɪ k
wəktɯb	w ə k t ʊ b
wɑlɑ	w ɑ l ɑ
wən	w ə n
wɨna̠ʔ	w ɪ n a ʔ
wɑpas	w ɑ p a s
wɑqt	w ɑ k t
wɑq̠wɑq̠	w ɑ k w ɑ k
wɛvit	w ɛ v i t
wəɽa	w ə ɹ a
wɨ̠d̠aʔ	w ɪ d a ʔ
wə̟i̯	w ə i
wɨʔi̠dip	w ɪ ʔ i d i p
wʌɹʌ	w ə ɹ ə
wɪ̰ʔ	w ɪ ʔ
wɑɕɑm	w ɑ ʃ ɑ m
xaber	f a b e ɾ
xasisi	f a s i s i
xaus	f a u s
xavĩː	f a v iː
xaz	f a z
xæːfəxə	f æ f ə f ə
xaːli	f aː l i
xaɔs	f a ɔ s
xe	f e
xiha	f i h a
xiŋhɔ	f i ŋ h ɔ
xlo	f l o
xl̥aːd̪	f l aː d̪
xmũ	f m u
xna	f n a
xoropɑ	f o ɾ o p ɑ
xoruɑ	f o ɾ u ɑ
xot̪	f o t̪
xoːɾas	f oː ɾ a s
xraːbar	f ɾ aː b a ɾ
xr̥aːm	f ɾ aː m
xt̪et̪i	f t̪ e t̪ i
xtɑɹ	f t ɑ ɹ
xukiɑ	f u k i ɑ
xuza	f u z a
xwa	f w a
xwli	f w l i
xwɛ	f w ɛ
xxəcin	f f ə c i n
xɛ	f ɛ
xəcin	f ə c i n
xɔisja	f ɔ i s j a
xɔizjɔ	f ɔ i z j ɔ
xɑr	f ɑ ɾ
xɔrɔn	f ɔ ɾ ɔ n
xɑzɔnkɑsɔn	f ɑ z ɔ n k ɑ s ɔ n
xəʔ	f ə ʔ
xɛ̠	f ɛ
xɒːbɒ	f ɒː b ɒ
xɔŋhɑr	f ɔ ŋ h ɑ ɾ
xʲɾrɡas	f ɾ ɾ ɡ a s
xɑ̃s	f ɑ s
xɑ̃sõ	f ɑ s o
xɑ̃sotiɑ	f ɑ s o t i ɑ
xːɔtɒ	f ɔ t ɒ
xɔŋxɑr	f ɔ ŋ f ɑ ɾ
xɑ̃z	f ɑ z
xɑ̃zõ	f ɑ z o
xːɔðɒ	f ɔ ð ɒ
y	i
ya	i a
yadⁿwili	i a d w i l i
yaʔ	i a ʔ
yaʕpqin	i a ɹ p k i n
ydɛ	i d ɛ
yew	i e w
yewhap	i e w h a p
yha	i h a
yli	i l i
yo	i o
yoːk	i oː k
yq̠ɛtʰ	i k ɛ tʰ
yrɛq̠	i ɾ ɛ k
yyː	i i
yzlɛtʰ	i z l ɛ tʰ
yʔ	i ʔ
yːr	i ɾ
yərr	i ə ɾ ɾ
yːz	i z
yəʔ	i ə ʔ
yœː	i oː
yɔː	i ɔ
yə̃n	i ə n
z	z
zadʰ	z a d
zahərə	z a h ə ɾ ə
zãma	z a m a
zampiq̠	z a m p i k
zamta	z a m t a
zarta	z a ɾ t a
zær̥	z æ ɾ
zaza	z a z a
zaɡ	z a ɡ
zaʔ	z a ʔ
zãɡa	z a ɡ a
zaʁakʰ	z a f a kʰ
zãːmõ	z aː m o
za̰ʔjoʊ̃ŋ	z a ʔ j o ʊ ŋ
zbivaɲe	z b i v a ɲ e
zd̪ravo	z d̪ ɾ a v o
ze	z e
zeni	z e n i
zeɪ	z e ɪ
zeɪjn̩	z e ɪ j n̩
zeːn̪a	z eː n  a
zirɑ	z i ɾ ɑ
ziyɒːd̪	z i i ɒː d̪
zlox	z l o f
zlʲnʲtʲ	z l ɲ tʲ
zmail	z m a i l
zmãn	z m a n
zn̪at̪i	z n  a t̪ i
zo	z o
zolɑ	z o l ɑ
zøm	z o m
zor	z o ɾ
zot̪	z o t̪
zoŋ	z o ŋ
zoː	z oː
zoʔɪshet	z o ʔ ɪ s h e t
zq̠rad̪a	z k ɾ a d̪ a
zu	z u
zuri	z u ɾ i
zuzɛt͡ʃa	z u z ɛ tʃ a
zuːm	z uː m
zvon̪it̪i	z v o n  i t̪ i
zzike	z z i k e
zʲænʲtas	z æ ɲ t a s
zɔhoa	z ɔ h o a
zɔhɑ	z ɔ h ɑ
zɑhərə	z ɑ h ə ɾ ə
zɛi	z ɛ i
zɔkɑ	z ɔ k ɑ
zɛkɑ	z ɛ k ɑ
zɑl	z ɑ l
zɪll	z ɪ l l
zʊll	z ʊ l l
zɪls	z ɪ l s
zələ	z ə l ə
zʊriɑ	z ʊ ɾ i ɑ
zɑt	z ɑ t
zɔt	z ɔ t
zɑʕ	z ɑ ɹ
zə̃mãm	z ə m a m
zə̃mãn	z ə m a n
zə̃maʁ	z ə m a f
ðabə	ð a b ə
ðanq̠ɔni	ð a n k ɔ n i
ðelə	ð e l ə
ðiɔ	ð i ɔ
ðuħɾ	ð u h ɾ
ðwɔa	ð w ɔ a
ðɔ	ð ɔ
ðələ	ð ə l ə
ðɒħɒbɒ	ð ɒ h ɒ b ɒ
ɔ	ɔ
ʃ	ʃ
ʌ	ə
ħa	h a
ŋa	ŋ a
ɓa	b a
ɡa	ɡ a
ɡã	ɡ a
ɣa	ɡ a
ɬa	ɫ a
ɲa	ɲ a
ʃa	ʃ a
ʒa	ʒ a
ʔa	ʔ a
θa	θ a
ɓaa	b a a
ɲaa	ɲ a a
ʃæb	ʃ æ b
ʐaba	ʒ a b a
ʔaba	ʔ a b a
χabar	f a b a ɾ
ʔabes	ʔ a b e s
ɾæbøɸ	ɾ æ b o ɸ
ɮabʷa	ɫ a b a
ʔabːes	ʔ a b e s
ħac	h a c
ỹãcĩ	i a c i
ħad	h a d
ʕad	ɹ a d
ʍada	w a d a
ħadar	h a d a ɾ
ʕadulf	ɹ a d u l f
ʕadə	ɹ a d ə
χæd̪əm	f æ d̪ ə m
ħæd̪əθ	h æ d̪ ə θ
ɾafəɫ	ɾ a f ə ɫ
ʂah	ʃ a h
ʔaha	ʔ a h a
ɸæhæɸ	ɸ æ h æ ɸ
ŋai	ŋ a i
ʔaia	ʔ a i a
ʕain	ɹ a i n
ɣaiðarɔs	ɡ a i ð a ɾ ɔ s
ɸaiɸai	ɸ a i ɸ a i
ʕaj	ɹ a j
ʒajt͡ɬ	ʒ a j tʃ
ħajə	h a j ə
ʁajɪθ	f a j ɪ θ
ʁak	f a k
ʀakav	ɾ a k a v
ʁaktə	f a k t ə
ʃak͡pa	ʃ a kp a
χakʰʲ	f a kʰ
χal	f a l
ɡala	ɡ a l a
ɣalabə	ɡ a l a b ə
ɢælætʰ	ɡ æ l æ tʰ
ʔalb	ʔ a l b
χalmaʕa	f a l m a ɹ a
ʃalõm	ʃ a l o m
ʔalpoq̠	ʔ a l p o k
ʃaltʲ	ʃ a l tʲ
ʒaltʲ	ʒ a l tʲ
ʃal̪pa	ʃ a l p a
ħal̪ʔ	h a l ʔ
ʒam	ʒ a m
ɕama	ʃ a m a
ɲama	ɲ a m a
ħambaʔ	h a m b a ʔ
ʕamkʼʲ	ɹ a m k
ʕamm	ɹ a m m
ħamtsʼəj	h a m t s ə j
ŋãmu	ŋ a m u
ʔamyan	ʔ a m i a n
ħan	h a n
ʕan	ɹ a n
ŋana	ŋ a n a
ʔana	ʔ a n a
ŋanaa	ŋ a n a a
ʒænb	ʒ æ n b
ɦandi	h a n d i
ʒandʰ	ʒ a n d
χane	f a n e
ɮant͡ʃa	ɫ a n tʃ a
ʁænə	f æ n ə
ʔænə	ʔ æ n ə
ħapː	h a p
ɲæpʷeɪ	ɲ æ pʷ e ɪ
ʃæpʷeɪ	ʃ æ pʷ e ɪ
ħar	h a ɾ
ʔar	ʔ a ɾ
ʕar	ɹ a ɾ
θar	θ a ɾ
ɲara	ɲ a ɾ a
ʑara	ʒ a ɾ a
ʔarado	ʔ a ɾ a d o
ʔarasikʷ	ʔ a ɾ a s i kʷ
ʕarcaban	ɹ a ɾ c a b a n
ʒærf	ʒ æ ɾ f
ʒari	ʒ a ɾ i
ʔarina	ʔ a ɾ i n a
ħarud	h a ɾ u d
ħarxas	h a ɾ f a s
ʕarxas	ɹ a ɾ f a s
ɢar̥	ɡ a ɾ
χar̥	f a ɾ
ʁarħas	f a ɾ h a s
ʃærəf	ʃ æ ɾ ə f
χæs	f æ s
ʔaslahp	ʔ a s l a h p
ɟat	ɟ a t
ɓata	b a t a
ʔata	ʔ a t a
ʕataʕas	ɹ a t a ɹ a s
ʔate	ʔ a t e
ʔatras	ʔ a t ɾ a s
ʃatu̥	ʃ a t u
ʒatu̥	ʒ a t u
ɪatə	ɪ a t ə
ɾat̪	ɾ a t̪
ɾatɪ̃	ɾ a t ɪ
ħatɕʼa	h a t ʃ a
ʁaunə	f a u n ə
ʃaut	ʃ a u t
ʒaut	ʒ a u t
ʔaut̪	ʔ a u t̪
ʒauz	ʒ a u z
ɟauː	ɟ a uː
θauː	θ a uː
ɢav	ɡ a v
ħaw	h a w
ʔaza	ʔ a z a
ɣazaɾ	ɡ a z a ɾ
ɾazo	ɾ a z o
ʁazʷ	f a z
ħæðɜr	h æ ð ɛ ɾ
ŋaɪ	ŋ a ɪ
ʃaɾ	ʃ a ɾ
ʃaʃ	ʃ a ʃ
ʃãʃ	ʃ a ʃ
ŋa̰	ŋ a
ħaɾa	h a ɾ a
ŋaŋa	ŋ a ŋ a
ʃaɽa	ʃ a ɹ a
ʔaʔa	ʔ a ʔ a
ˀaχa	a f a
ʃaʁakʰ	ʃ a f a kʰ
ɲaɲam	ɲ a ɲ a m
ħæʒar	h æ ʒ a ɾ
ʃaʕb	ʃ a ɹ b
ʃaɪdʌ	ʃ a ɪ d ə
ʃaːi	ʃ aː i
ʔaʔiaʔi	ʔ a ʔ i a ʔ i
ʔaʔiː	ʔ a ʔ iː
ħaɪjjə	h a ɪ j j ə
ħaɪjə	h a ɪ j ə
ɗaːki	d  aː k i
ɣaːli	ɡ aː l i
ʃaːlu	ʃ aː l u
ɸãːma	ɸ aː m a
ŋaːn	ŋ aː n
ŋaːp	ŋ aː p
ʔãŋq̠litʰ	ʔ a ŋ k l i tʰ
ħaɪr	h a ɪ ɾ
ħaɪt̪	h a ɪ t̪
ɳaɳɔ	ɲ  a ɲ  ɔ
ɕaɡʷ	ʃ a ɡʷ
ˀaʒə	a ʒ ə
ħaːɾa	h aː ɾ a
ɬaɡʷandʑa	ɫ a ɡʷ a n d ʒ a
ħæʒʒar	h æ ʒ ʒ a ɾ
ɓaːɽe	b aː ɹ e
ɗãːʃi	d  aː ʃ i
ɡaːʃi	ɡ aː ʃ i
ɽaːɽi	ɹ aː ɹ i
ʁaɑːnə	f a ɑː n ə
ˀaχɤ̈	a f ʊ
ʔaʃɨɽĩn	ʔ a ʃ ɪ ɹ i n
ˀaʒəħʷərə	a ʒ ə h ə ɾ ə
ɔba	ɔ b a
ɛba	ɛ b a
ʔbaɬa	ʔ b a ɫ a
ʒbint̪	ʒ b i n t̪
ɪbn̩	ɪ b n̩
ɑbu	ɑ b u
ɔbɔ	ɔ b ɔ
əbə	ə b ə
ɛbɛ	ɛ b ɛ
ɛbɪ	ɛ b ɪ
ʔb͡da	ʔ b a
ɛbːɛ	ɛ b ɛ
ăbʒʲɨ	a b ʒ ɪ
ɔcami	ɔ c a m i
ɔcɔ	ɔ c ɔ
ɔd	ɔ d
ʔda	ʔ d a
ɔde	ɔ d e
ɛditʰ	ɛ d i tʰ
ʒdiːdiː	ʒ d iː d iː
əduqʰ	ə d u kʰ
ɔdza	ɔ d z a
ɛdzetʰː	ɛ d z e tʰ
ɛdɛ	ɛ d ɛ
ɛdːiq̠	ɛ d i k
ɔdɛɛ	ɔ d ɛ ɛ
ɔd̠ʒa	ɔ d ʒ a
ɛd̠ʐaŋ	ɛ d ʒ a ŋ
ɛd̠ʑesi	ɛ d ʒ e s i
ɛd̠ʑʷaeho	ɛ d ʒ a e h o
ʃe	ʃ e
ɬecʼil	ɫ e c i l
ħedːʒa	h e d ʒ a
ʃein	ʃ e i n
ɓeke	b e k e
ʃekl	ʃ e k l
ħel̪u	h e l u
ʃenã	ʃ e n a
ɲerije	ɲ e ɾ i j e
ʃerːvːɛl	ʃ e ɾ v ɛ l
ɓes	b e s
ʔevaʔeva	ʔ e v a ʔ e v a
ʃeɪ	ʃ e ɪ
χeɪli	f e ɪ l i
ʃeːnã	ʃ eː n a
ʃeːrvɛ	ʃ eː ɾ v ɛ
ʃeːʔl̥	ʃ eː ʔ l
ʒeʁɑ̃n	ʒ e f ɑ n
ɔfa	ɔ f a
ɛfe	ɛ f e
ɛfɛ	ɛ f ɛ
ɛfː	ɛ f 
ɔfɔjtɔ	ɔ f ɔ j t ɔ
ɔfːɔjtɔ	ɔ f  ɔ j t ɔ
ɔha	ɔ h a
ɔhetuk	ɔ h e t u k
ɑhu	ɑ h u
ŋhwaʔa	ŋ h w a ʔ a
ɛhɛ	ɛ h ɛ
ɑhɑr	ɑ h ɑ ɾ
ɛhɛr	ɛ h ɛ ɾ
ɡhɔrxitɔ	ɡ h ɔ ɾ f i t ɔ
ɓhəɽə	b h ə ɹ ə
ɡhəɽʌ	ɡ h ə ɹ ə
ŋi	ŋ i
ɓi	b i
θi	θ i
ʔid͡ʒɑɪ	ʔ i dʒ ɑ ɪ
ʃijĩ	ʃ i j i
ŋilʔɑd	ŋ i l ʔ ɑ d
ɲimɛ	ɲ i m ɛ
χintʰa	f i n tʰ a
ɾipɑ	ɾ i p ɑ
ʔitik	ʔ i t i k
ɬitʼɛʃ	ɫ i t ɛ ʃ
ɕiʔ	ʃ i ʔ
ʎiʎa	ʎ i ʎ a
ʔi̠dip	ʔ i d i p
ɑiːhɑn	ɑ iː h ɑ n
ʃiʒiʒ	ʃ i ʒ i ʒ
ʃiʃmɑx	ʃ i ʃ m ɑ f
θiŋq̠	θ i ŋ k
ɾiːvaz	ɾ iː v a z
ʃiɲɛɛ	ʃ i ɲ ɛ ɛ
ɔja	ɔ j a
ɟja	ɟ j a
ʔjaha	ʔ j a h a
ɲjaːja	ɲ j aː j a
ħjaːr	h j aː ɾ
ɔjimoderə	ɔ j i m o d e ɾ ə
ɔjimotulə	ɔ j i m o t u l ə
ɔjimɔda	ɔ j i m ɔ d a
ɔjimɔta	ɔ j i m ɔ t a
θjoutn̥	θ j o u t n
θjouːn	θ j o uː n
ɑjɑ	ɑ j ɑ
ɔjɔ	ɔ j ɔ
ăjăr	a j a ɾ
ɔjɔʃ	ɔ j ɔ ʃ
ɟjəɽa	ɟ j ə ɹ a
ɟjəɽe	ɟ j ə ɹ e
ɟjəɽi	ɟ j ə ɹ i
ĩj̃ĩj̃ã	i j i j a
ɟjəɽo	ɟ j ə ɹ o
ɟjəɽu	ɟ j ə ɹ u
ɟjəɽɔ	ɟ j ə ɹ ɔ
ɟjəɽɛ	ɟ j ə ɹ ɛ
ŋkaʃə	ŋ k a ʃ ə
ʃke	ʃ k e
ɔkor	ɔ k o ɾ
ɔkpɔtɔt̪kwu	ɔ k p ɔ t ɔ t̪ k w u
ũkupi	u k u p i
ŋkwa	ŋ k w a
ŋkɛ	ŋ k ɛ
ɔkɛ	ɔ k ɛ
ɛkɔ	ɛ k ɔ
əkək	ə k ə k
ŋk͡pɔ	ŋ kp ɔ
ɛk͡pɛ	ɛ kp ɛ
ɔkʏr	ɔ k u ɾ
əkʰu	ə kʰ u
əkʷəkʷ	ə kʷ ə kʷ
ɪkʼɑ̤hkõĩ	ɪ k ɑ h k o i
ŋkɔχɛtu̥	ŋ k ɔ f ɛ t u
ɛl	ɛ l
ɔla	ɔ l a
ɛla	ɛ l a
χladə	f l a d ə
χlat	f l a t
ɑlmɑx	ɑ l m ɑ f
ʃloje	ʃ l o j e
œlt	o l t
ɔlɔ	ɔ l ɔ
ɔlɛ	ɔ l ɛ
ɑl̴l̴	ɑ l̴ l̴
ɑlʔo	ɑ l ʔ o
ɔl̥ɔ	ɔ l ɔ
ɪlʒɪʃ	ɪ l ʒ ɪ ʃ
ŋma	ŋ m a
ʌmar	ə m a ɾ
ʊmaɲmada	ʊ m a ɲ m a d a
ʊmaɲmederə	ʊ m a ɲ m e d e ɾ ə
ʊmaɲmetulə	ʊ m a ɲ m e t u l ə
ɔme	ɔ m e
əmom	ə m o m
ĩmon̪	i m o n 
ɔmu	ɔ m u
ɑmɑ	ɑ m ɑ
ɛmɛ	ɛ m ɛ
ŋmɡbe	ŋ m ɡ b e
ʊmɛmiida	ʊ m ɛ m i i d a
ʊmɛmiider	ʊ m ɛ m i i d e ɾ
ʊmɛmiita	ʊ m ɛ m i i t a
ʊmɛmiitul	ʊ m ɛ m i i t u l
ɔmɔne	ɔ m ɔ n e
ɔna	ɔ n a
ʃni	ʃ n i
ɑnq̠uɾ	ɑ n k u ɾ
ɪntiː	ɪ n t iː
əntɛnde	ə n t ɛ n d e
ăntʲs	a n tʲ s
ɑnzɑ	ɑ n z ɑ
ɑnɑ	ɑ n ɑ
ɛn̠jɛ	ɛ n j ɛ
ɪnẽnɑjei	ɪ n e n ɑ j e i
ɑnɑɾ	ɑ n ɑ ɾ
ɛnəɹ	ɛ n ə ɹ
ɛnʔəɹ	ɛ n ʔ ə ɹ
ɓo	b o
ɡo	ɡ o
ʃo	ʃ o
ɾobe	ɾ o b e
ʃole	ʃ o l e
ʀõm	ɾ o m
ʒømbeːkʰ	ʒ o m b eː kʰ
βonna	v o n n a
ɾoq̠ard̪ta	ɾ o k a ɾ d̪ t a
ʃoqʰeɪ	ʃ o kʰ e ɪ
ʃor	ʃ o ɾ
ʔosɛf	ʔ o s ɛ f
ʔowa	ʔ o w a
ɾowoq̠iq̠	ɾ o w o k i k
ŋõwː	ŋ o w
χoy	f o i
ɾoz	ɾ o z
ʁozə	f o z ə
ʃoːle	ʃ oː l e
ʃøːtʰ	ʃ o tʰ
ʁo̝ðə	f o ð ə
ʔoɯɾq̠ɑnoɯ	ʔ o ʊ ɾ k ɑ n o ʊ
ʀoʃɛ̃	ɾ o ʃ ɛ
ʁoʃɛ̃	f o ʃ ɛ
θoʊ̃ŋna	θ o ʊ ŋ n a
ɲp	ɲ p
ɛpa	ɛ p a
ɔpals	ɔ p a l s
ɔpia	ɔ p i a
ɑpo	ɑ p o
ɔpo	ɔ p o
ɑpu	ɑ p u
ɔpu	ɔ p u
ʃpukɛʃni	ʃ p u k ɛ ʃ n i
ɔpɛ	ɔ p ɛ
ɛpɔ	ɛ p ɔ
χpʰæ̈	f pʰ æ
ɔpʲæɾa	ɔ pʲ æ ɾ a
əpʰeɪ	ə pʰ e ɪ
əpʰija	ə pʰ i j a
ɔq̠	ɔ k
ŋq̠anə	ŋ k a n ə
ŋq̠eq̠e	ŋ k e k e
ɪq̠ers	ɪ k e ɾ s
ʃq̠iʔa	ʃ k i ʔ a
ũq̠li	u k l i
ăq̠ri	a k ɾ i
ɔq̠ɔ	ɔ k ɔ
ɛq̠ɛ	ɛ k ɛ
ɑq̠ɑɾ	ɑ k ɑ ɾ
ĩq̠ɑ̃	i k ɑ
ɑr	ɑ ɾ
ɛra	ɛ ɾ a
ɛrq̠eɾ	ɛ ɾ k e ɾ
ɑrɑ	ɑ ɾ ɑ
ɛrχ	ɛ ɾ f
ɛrː	ɛ ɾ
ɛr̥ta	ɛ ɾ t a
ɛrːɛ	ɛ ɾ ɛ
ʌr̟ʌ	ə ɾ ə
ʌr̠ʌ	ə ɾ ə
ɔsa	ɔ s a
ɛsei	ɛ s e i
ʈsemer	ʈ s e m e ɾ
ʊsin	ʊ s i n
ɔso	ɔ s o
ɛso	ɛ s o
ɛsɛ	ɛ s ɛ
ɪsː	ɪ s
ɔsɔrɔ	ɔ s ɔ ɾ ɔ
ɛsɛʃ	ɛ s ɛ ʃ
ɑt	ɑ t
ɛta	ɛ t a
ɪto	ɪ t o
ɛtoʃii	ɛ t o ʃ i i
ɛtsɛtʰ	ɛ t s ɛ tʰ
ɪtsɑɑ	ɪ t s ɑ ɑ
ɔtɔ	ɔ t ɔ
ɔtɛ	ɔ t ɛ
ɛtɛ	ɛ t ɛ
ɪtʰæɾaeqʰ	ɪ tʰ æ ɾ a e kʰ
ɞtʰu	ə tʰ u
ɑt̪ɑ	ɑ t̪ ɑ
ɑt̪ʰ	ɑ tʰ
ɑt͡ʃmɑx	ɑ tʃ m ɑ f
ɔtɛ̃nɛ	ɔ t ɛ n ɛ
ɔtʰɔtʰ	ɔ tʰ ɔ tʰ
ətɪ̃ŋ	ə t ɪ ŋ
ɔt̠ʃɛ	ɔ t ʃ ɛ
ɔtɛ̃ʔnɛ	ɔ t ɛ ʔ n ɛ
ɛt̠ɕʷukʷɪ	ɛ t ʃ u kʷ ɪ
ɔt̠ʃʷɔɛ	ɔ t ʃ ɔ ɛ
ɛt͡ʃʰɪ̃	ɛ tʃ ɪ
ət͡ʃẽɪ̃ŋ	ə tʃ e ɪ ŋ
ĩu	i u
ŋu	ŋ u
ʁuaɡʷ	f u a ɡʷ
ŋue	ŋ u e
ʃuk	ʃ u k
ʃukat̪u	ʃ u k a t̪ u
ʁulə	f u l ə
ɬum	ɫ u m
χunæm	f u n æ m
χune	f u n e
ɢur̥	ɡ u ɾ
χusi	f u s i
ɡusuɑ	ɡ u s u ɑ
ɲuː	ɲ uː
ɲuːjtʰ	ɲ uː j tʰ
ħuːt̪	h uː t̪
ŭuʃʲtʲ	u u ʃ tʲ
ʔuːʔuː	ʔ uː ʔ uː
əvãːðʲi	ə v aː ð i
əviː	ə v iː
ɛvɔ̃	ɛ v ɔ
ŋwai	ŋ w a i
ʔwala	ʔ w a l a
βwato	v w a t o
ŋwe	ŋ w e
ŋwewep	ŋ w e w e p
əweɪ	ə w e ɪ
ŋwo	ŋ w o
ɔwoɹe	ɔ w o ɹ e
əwutʰ	ə w u tʰ
ɔwɔ	ɔ w ɔ
ɔw̃a	ɔ w a
ŋwɛd	ŋ w ɛ d
ʊwɔmuderə	ʊ w ɔ m u d e ɾ ə
ʊwɔmutulə	ʊ w ɔ m u t u l ə
ʊwɔmʊda	ʊ w ɔ m ʊ d a
ʊwɔmʊta	ʊ w ɔ m ʊ t a
ŋwɔn	ŋ w ɔ n
ɛwɛrɛ	ɛ w ɛ ɾ ɛ
əwɔtʰ	ə w ɔ tʰ
ŋwɔŋ	ŋ w ɔ ŋ
ɛw̃ɛ̃	ɛ w ɛ
ɔxa	ɔ f a
ɔxex	ɔ f e f
ɑxu	ɑ f u
ɔxɔhɔzoɡ	ɔ f ɔ h ɔ z o ɡ
ɔxɑr	ɔ f ɑ ɾ
ɛxɛr	ɛ f ɛ ɾ
ɑz	ɑ z
ɔz	ɔ z
ɛz	ɛ z
ɖzaba	ɖ z a b a
ɖzak	ɖ z a k
ʊzin	ʊ z i n
ɛzɛ	ɛ z ɛ
ɑʃ	ɑ ʃ
ɓɔ	b ɔ
ɔɔ	ɔ ɔ
əŋ	ə ŋ
əʔ	ə ʔ
ɪʉ	ɪ ʉ
ʌɯ	ə ʊ
ŋ̩	ŋ
ɲɲa	ɲ ɲ a
ʔʷafə	ʔ a f ə
ɖʰakkɵ	ɖ a k k ə
ʎ̥ala	ʎ a l a
ɡăalas	ɡ a a l a s
ɡʲæltʲ	ɡ æ l tʲ
ɔɟanɖɛ	ɔ ɟ a n ɖ ɛ
ɡʷapʰa	ɡʷ a pʰ a
ʁʷar	f  a ɾ
ŋɡaŋ	ŋ ɡ a ŋ
ɲ̥ãŋ	ɲ a ŋ
ŋŋaŋa	ŋ ŋ a ŋ a
ɡʷaɕa	ɡʷ a ʃ a
ʔʷaħa	ʔ a h a
ɡ͡batɛ	ɡb a t ɛ
ɖʌbbi	ɖ ə b b i
ʕɒbisɒ	ɹ ɒ b i s ɒ
ɡʷbʁua	ɡʷ b f u a
θɛcːɪr	θ ɛ c ɪ ɾ
ʃɪde	ʃ ɪ d e
ɑʒdəhɑɾ	ɑ ʒ d ə h ɑ ɾ
ɢʲel	ɡ e l
əʃeɪ	ə ʃ e ɪ
ɛɱfaʃi	ɛ m f a ʃ i
ɾɑh	ɾ ɑ h
ʌɖhi	ə ɖ h i
ʌɖi	ə ɖ i
ɔːi	ɔ i
ə̟i̯	ə i
ʊ̟i̯	ʊ i
ə̟i̯k	ə i k
ə̟i̯l	ə i l
ə̟i̯s	ə i s
ʊ̟i̯t	ʊ i t
əʔjuwə	ə ʔ j u w ə
ɔɟjəɽɛtii	ɔ ɟ j ə ɹ ɛ t i i
ɔɟjəɽɛɛti	ɔ ɟ j ə ɹ ɛ ɛ t i
χɑk	f ɑ k
χɑki	f ɑ k i
ʃɛkl	ʃ ɛ k l
ɗɨkʰa	d  ɪ kʰ a
ɪʃkĩn	ɪ ʃ k i n
ɔːkʏr	ɔ k u ɾ
ʃɛl	ʃ ɛ l
ʒɛl	ʒ ɛ l
œːl	oː l
ʔəla	ʔ ə l a
ʃʲlas	ʃ l a s
ʒʲlas	ʒ l a s
ʒɑli	ʒ ɑ l i
ħɑlib	h ɑ l i b
ɣʏlmɑx	ɡ u l m ɑ f
ʒɒlɒbɒ	ʒ ɒ l ɒ b ɒ
ʁʌləʔ	f ə l ə ʔ
χʌləʔ	f ə l ə ʔ
ɾɑm	ɾ ɑ m
ʃɑm	ʃ ɑ m
χɑm	f ɑ m
ʃɑmpɑɲə	ʃ ɑ m p ɑ ɲ ə
ɔɔmu	ɔ ɔ m u
ʃʌmɑ	ʃ ə m ɑ
ɟɪmɛnɛ	ɟ ɪ m ɛ n ɛ
ɹəmətʌ	ɹ ə m ə t ə
ʃʃmɑx	ʃ ʃ m ɑ f
ŋɔmɔɔ	ŋ ɔ m ɔ ɔ
ɡɔmɛɛ	ɡ ɔ m ɛ ɛ
ŋən	ŋ ə n
ɾɑn	ɾ ɑ n
ə̃n	ə n
ɲəna	ɲ ə n a
ɾɑnd͡ʒ	ɾ ɑ n dʒ
ʒɑndɑɾm	ʒ ɑ n d ɑ ɾ m
ɾɑnq̠	ɾ ɑ n k
ʔʷntɕʼəbza	ʔ n t ʃ ə b z a
ʃɛnəb	ʃ ɛ n ə b
ɣɾot	ɡ ɾ o t
ʃɛq̠	ʃ ɛ k
ɾɛq̠ɑːloɯ	ɾ ɛ k ɑː l o ʊ
ɣər	ɡ ə ɾ
ɛːr	ɛ ɾ
ɡărdas	ɡ a ɾ d a s
θɑrə	θ ɑ ɾ ə
ɾɑs	ɾ ɑ s
ɪːs	ɪ s
ũχsil	u f s i l
χɔsː	f ɔ s
ũːsə	uː s ə
ɑːt	ɑː t
ŋɑtɑ	ŋ ɑ t ɑ
ʔɛtʰ	ʔ ɛ tʰ
χɔt͡ʃ	f ɔ tʃ
ɲɛt͡ʃiː	ɲ ɛ tʃ iː
ɪ̃t͡ʃõ	ɪ tʃ o
ʁʷt͡ʃʼə	f  tʃ ə
ʃɪuja	ʃ ɪ u j a
ɛʃuq̠uh	ɛ ʃ u k u h
ɤːvər	ʊ v ə ɾ
ɣəz	ɡ ə z
ɾɑz	ɾ ɑ z
χɔzː	f ɔ z
ɡɛzɛrɑ	ɡ ɛ z ɛ ɾ ɑ
ɛːða	ɛ ð a
ŋəʔ	ŋ ə ʔ
ɔŋə	ɔ ŋ ə
ɔɖɛ	ɔ ɖ ɛ
ɔɟɔ	ɔ ɟ ɔ
ɔɡɔ	ɔ ɡ ɔ
ɔɲɔ	ɔ ɲ ɔ
ɗɛʃ	d  ɛ ʃ
ɛɟɪ	ɛ ɟ ɪ
ɛβɛ	ɛ v ɛ
ɦəɭ	h ə ɫ
ɦəʔ	h ə ʔ
ɲɔŋ	ɲ ɔ ŋ
ʁɑʔ	f ɑ ʔ
ʔɔɪ	ʔ ɔ ɪ
ʕɑɾ	ɹ ɑ ɾ
χɔʃ	f ɔ ʃ
ɗɔː	d  ɔ
ɛɟː	ɛ ɟ
ɛɡʷa	ɛ ɡʷ a
ɔəɡatʲ	ɔ ə ɡ a tʲ
ʃəʀatʰ	ʃ ə ɾ a tʰ
ʃɑːb	ʃ ɑː b
ɔɡ͡ba	ɔ ɡb a
ɣɒːbɒ	ɡ ɒː b ɒ
ʕɒːbɒ	ɹ ɒː b ɒ
ʔɛːd	ʔ ɛ d
ɛɡɛdɛ	ɛ ɡ ɛ d ɛ
ʌɳɖhaɹu	ə ɲ  ɖ h a ɹ u
ɦə̟i̯	h ə i
ɦʊ̟i̯s	h ʊ i s
ʃəɯki	ʃ ə ʊ k i
ʕʷəl	ɹ ə l
χə̃m	f ə m
əʂəman	ə ʃ ə m a n
əʂʌman	ə ʃ ə m a n
ɣɑʃmax	ɡ ɑ ʃ m a f
ɔ̃ŋmɡbĩã	ɔ ŋ m ɡ b i a
ɣɑʃmɑx	ɡ ɑ ʃ m ɑ f
ɣɤɹmɑx	ɡ ʊ ɹ m ɑ f
ŋɡɔnɔɔ	ŋ ɡ ɔ n ɔ ɔ
ɲɔ̃p	ɲ ɔ p
ɔ̆əq̠a	ɔ ə k a
ɔ̃ŋq̠o	ɔ ŋ k o
ɟɛːr	ɟ ɛ ɾ
θɪŋs	θ ɪ ŋ s
χɑɾs	f ɑ ɾ s
ɑʁətɔ	ɑ f ə t ɔ
ăʃʲtʲ	a ʃ tʲ
ɑʕɑz	ɑ ɹ ɑ z
ŋɑŋɑ	ŋ ɑ ŋ ɑ
ɓəɽə	b ə ɹ ə
ɔɲɛɛ	ɔ ɲ ɛ ɛ
ɡəɽʌ	ɡ ə ɹ ə
ɔɲːɔ	ɔ ɲ ɔ
ʔɔ̃ŋ	ʔ ɔ ŋ
ḛɪ̰ʔ	e ɪ ʔ
ẽɪ̃ŋ	e ɪ ŋ
ĩːʃə	iː ʃ ə
ʔɑɪːhɑn	ʔ ɑ ɪ h ɑ n
ʔɑɯːhɑq̠	ʔ ɑ ʊ h ɑ k
ɔŋɔɲi	ɔ ŋ ɔ ɲ i
ʃʲəɹp	ʃ ə ɹ p
ħɒɾɒsɒ	h ɒ ɾ ɒ s ɒ
ɑʁʁɔtɔ	ɑ f f ɔ t ɔ
ɣɑʃɛt̪ʰmɑx	ɡ ɑ ʃ ɛ tʰ m ɑ f
ɲɔ̃ːy	ɲ ɔ i
θɪɲɟɪ	θ ɪ ɲ ɟ ɪ
ʃɪ̰̃ŋ	ʃ ɪ ŋ
ʃɒʕɒɾə	ʃ ɒ ɹ ɒ ɾ ə
ɣɾʉʋɫ̩	ɡ ɾ ʉ ʋ ɫ̩
ɡʷəɕəʔa	ɡʷ ə ʃ ə ʔ a
ʌɳɖəɹɳu	ə ɲ  ɖ ə ɹ ɲ  u
